爱宠大机密	PetPet当家	宠物当家
海洋之歌	海洋幻想曲	LeChantdelaMer
疯狂动物城	优兽大都会	动物方城市
冰川时代5：星际碰撞	冰川时代5	冰原历险记5：笑星撞地球
大鱼海棠
愤怒的小鸟	愤怒鸟大电影	愤怒鸟玩电影
奇幻森林	与森林共舞	丛林之书
千与千寻	神隐少女	SpiritedAway
西游记之大圣归来	大圣归来
超能陆战队	大英雄联盟	大英雄天团
哆啦A梦：新·大雄的日本诞生
马男波杰克第三季
头脑特工队	玩转脑朋友	脑筋急转弯
功夫熊猫3	熊猫阿宝3	阿宝正传3
机器人总动员	瓦力	太空奇兵·威E
飞屋环游记	冲天救兵	天外奇迹
马男波杰克第一季
精灵王座	ThroneofElves
疯狂原始人	古鲁家族	克鲁德一家
冰雪奇缘	魔雪奇缘	冰雪大冒险
魔弦传说	久保与二弦琴	酷宝：魔弦传说
驯龙高手	驯龙记
神偷奶爸	卑鄙的我	坏蛋奖门人
小王子	TheLittlePrince
天空之城	TenkûnoshiroRapyuta	Laputa:CastleintheSky
哈尔的移动城堡	呼啸山城	霍尔的移动城堡
萤火之森	萤火之社	Hotarubinomorie
冰川时代	冰河世纪	冰原历险记
怪兽电力公司	怪兽公司	怪物公司
红辣椒	盗梦侦探	帕布莉卡
马男波杰克第二季
狮子王	狮子王3D
怪兽大学	怪兽电力公司2：怪兽大学	怪物公司2：怪物大学
秒速5厘米	秒速五厘米	秒速5公分
无敌破坏王	破坏王拉尔夫	破坏王大冒险
蝙蝠侠：致命玩笑
借东西的小人阿莉埃蒂	借物少女艾莉缇	借东西的小矮人亚莉亚蒂
冰川时代4	冰河世纪4：玩转新大陆	冰原历险记4：板块漂移
小门神	LittleDoorGods
海底总动员	海底奇兵	寻找尼莫
香肠派对	肠肠搞轰趴	食物总动员
神偷奶爸2	卑鄙的我2	坏蛋奖门人2
穿越时空的少女	跳跃吧时空少女	Tokiokakerushôjo
里约大冒险	奇鹦嘉年华	鹦鹉布鲁
精灵旅社2	尖叫旅社2	鬼灵精怪大酒店2
凯尔经的秘密	凯尔斯的秘密	凯尔斯修道院的秘密
幽灵公主	魔法公主	幽灵少女
海底总动员2：多莉去哪儿	海底总动员2：寻找多莉	寻找多莉
明月守护者	月亮守护者
功夫熊猫2	熊猫阿宝2	阿宝正传2
名侦探柯南：纯黑的噩梦	名侦探柯南：剧场版20	名侦探柯南：2016年剧场版
魔女宅急便	魔女琪琪	小魔女限时专送
玛丽和马克思	巧克力情缘	玛丽和麦克斯
辉夜姬物语	辉耀姬物语	辉夜姬的故事
冰川时代3	冰河世纪3：大威龙驾到	冰河时代3：恐龙的黎明
风之谷	风谷少女	KazenotaninoNaushika
玩具总动员3	反斗奇兵3	玩具的故事3
美食总动员	料理鼠王	五星级大鼠
侧耳倾听	心之谷	梦幻街少女
小黄人大眼萌	小黄人	迷你兵团
诺亚方舟漂流记	诺亚方舟大冒险	诺亚方舟：幸存的家伙们
瑞克和莫蒂第一季	瑞奇和莫迪
哆啦A梦：伴我同行	与我同行的哆啦A梦	机器猫：伴我同行
阿薇尔与虚构世界	蒸汽女孩与不死猫	艾薇尔与虚构世界
未麻的部屋	蓝色的恐惧	蓝色恐惧
驯龙高手2	驯龙记2
功夫熊猫	熊猫阿宝	阿宝正传
火影忍者剧场版：博人传	火影忍者剧场版：幕留人	火影忍者剧场版：博人
龙猫	邻家的豆豆龙	隔壁的特特罗
精灵旅社	尖叫旅社	鬼灵精怪大酒店
小羊肖恩	小羊肖恩大电影	超级无敌羊咩咩大电影之咩最劲
千年女优	MillenniumActress
冰川时代2：融冰之灾	冰川时代2	冰河世纪2：消融
悬崖上的金鱼姬	崖上的波妞	崖上的波儿
攻壳机动队	GhostintheShell
僵尸新娘	骷髅新娘	怪诞尸新娘
恐龙当家	恐龙大时代	美好的恐龙世界
瑞克和莫蒂第二季	瑞奇和莫迪第二季
玩具总动员	反斗奇兵	玩具的故事
了不起的狐狸爸爸	超级狐狸先生	狐狸先生无得顶
萤火虫之墓	再见萤火虫	萤火挽歌
她和她的猫-EverythingFlows-	SheandHerCatEverythingFlows
在下坂本，有何贵干	我叫坂本我最屌
狼的孩子雨和雪	狼之子雨与雪	Okamikodomonoametoyuki
魔发奇缘	魔髮奇緣	长发姑娘
你看起来好像很好吃	你好像很美味啊	我的暴龙老爸
怪物之子	怪物的孩子	BakemononoKo
言叶之庭	言语之庭	语言之庭
君之名	你的名字	YourName
起风了
夏日大作战	夏日战争	夏日大战争
东京教父	TokyoGodfathers	东京教父
男孩与世界	男孩和世界	囧男孩看世界
灵能百分百	路人超能100
红猪	飞天红猪侠	PorcoRosso
鬼妈妈	卡罗琳	卡罗兰
Re：从零开始的异世界生活	Re：Lifeinadifferentworldfromzero
超人总动员	超人特攻队	超人家族
温暖的印记	暖心手账	温情点滴
大闹天宫	大闹天宫上下集	TheMonkeyKing
齐木楠雄的灾难	超能力者齐木楠雄的灾难
猫的报恩	猫之报恩	Nekonoongaeshi
疯狂约会美丽都	佳丽村三姊妹	美丽城三重唱
新大头儿子和小头爸爸2一日成才	新大头儿子和小头爸爸2	新大头儿子和小头爸爸2：一日成才
咱们裸熊第一季	熊熊遇见你	熊熊三贱客
一拳超人	一击超人	一击男
岁月的童话	回忆点点滴滴	儿时的点点滴滴
同级生	Doukyuusei
昭和元禄落语心中	昭和元禄落语心中	ShouwaGenrokuRakugoShinjuu
马达加斯加3	马达加斯加3：欧洲大围捕	荒失失奇兵3：欧洲逐只捉
你看起来很可怕	鳄鱼拔牙记
麦兜故事	麦兜的故事	MyLifeasMcDull
我在伊朗长大	茉莉人生	波斯波利斯
帕丁顿熊	柏灵顿	柏灵顿：熊爱趴趴走
钢之炼金术师FA	钢之炼金术师BROTHERHOOD	钢之炼金术师2009
马达加斯加	荒失失奇兵	马达加斯加
漫漫北寻路	LongWayNorth	Alsostredelmón
神秘世界历险记3	奇异家族
咱们裸熊第二季	熊熊三贱客	咱好熊弟
宝莲灯	LotusLantern
怪物史瑞克	怪物史莱克	史瑞克
里约大冒险2	奇鹦嘉年华2
名侦探柯南：业火的向日葵	名侦探柯南：业火中的向日葵	名侦探柯南2015：业火的向日葵
攻壳机动队2：无罪	GhostintheShell2:Innocence
一条大鱼叫海棠	MyFishBoyfriend
勇敢传说	勇敢传说之幻险森林
兰戈	飙风雷哥	马拉高
夏目友人帐	妖怪联络簿一
艾特熊和赛娜鼠	花都友奇缘	奥尼熊与莎琳鼠
花木兰	ChinaDoll
腌黄瓜先生第一季
玩具总动员2	反斗奇兵2	反斗奇兵续集
穿靴子的猫	靴猫外传	鞋猫剑客
花与爱丽丝杀人事件	HanatoAliceSatsujinJiken	TheCaseofHana&Alice
美女与野兽	美女与野兽3D
哪吒闹海	PrinceNezha'sTriumphAgainstDragonKing	Nezhanaohai
疯狂外星人	无敌安乐窝
马达加斯加的企鹅	马达加斯加爆走企鹅	荒失失企鹅
甲铁城的卡巴内瑞	甲铁城的卡巴内里	甲铁城的尸人
虫师	むしし	mushishi
河童之夏	Kappanokutonatsuyasumi	河童之夏
赛车总动员	反斗车王	汽车总动员
父与女	岸辺のふたり
给桃子的信	给小桃的信	小桃の奇幻手纸
天降美食	美食从天而降	美食风球
记忆中的玛妮	回忆中的玛妮	OmoidenoMarnie
天书奇谭	TheLegendofSealedBook
雇佣人生	螺丝人生	雇工人生
伤物语1：铁血篇	KizumonogatariPart1:Tekketsu-hen
虞美人盛开的山坡	红花坂上的海	来自红花坂
阿修罗	Asura
银魂	Gintama
超级大坏蛋	麦克迈：超能坏蛋	毛百万
马达加斯加2：逃往非洲	荒失失奇兵2	马达加斯加2
天才眼镜狗	百宝狗先生与细蚊：时光机大历险	皮巴弟先生与薛曼的时光冒险(台
麦兜当当伴我心	腰花伴菜芯	麦兜故事5
灌篮高手	篮球飞人	男儿当入樽
安诺玛丽莎	不正常丽莎
守护者联盟	五星大联盟	捍卫联盟
收获之夜
镇魂街	RakshasaStreet
云端之上	KumoniNoru
精神分裂症	91公分之外	貌合神离
葫芦兄弟	葫芦娃
猫和老鼠	妙妙妙	汤姆猫与杰米鼠
阿基拉	光明战士阿基拉	亚基拉
海贼王	航海王	OnePiece
妄想代理人	Mousoudairinin
星之梦
麦兜我和我妈妈	麦兜·我和我妈妈	麦兜故事6
心理游戏	心灵游戏	MindGame
名侦探柯南	DetectiveConan	MeitanteiConan
海贼王特别篇：黄金之心
我们仍未知道那天所看见的花的名字	彼花未知名	未知彼时花开名
回忆积木小屋	积木之家	Tsumikinoie
星际牛仔	赏金猎人	宇宙牛仔
命运石之门	斯坦因之门	Steins;Gate
机械心	心之动力学	TheBoywiththeCuckoo-ClockHeart
魔术师	幻术家	幻术师
亚尔斯兰战记风尘乱舞	阿斯兰战记：风尘乱舞	亚尔斯兰战记第二季
重生计划	重返17岁
圣诞夜惊魂	怪诞城之夜	圣诞夜惊魂
吸血鬼猎人D	VampireHunterD:Bloodlust
新世纪福音战士	NeonGenesisEvangelion	NewCenturyEvangelion
只有我不存在的城市	只有我不在的街道	TheTownWhereOnlyIAmMissing
百变狸猫	平成狸合战	狸猫物语
白雪公主和七个小矮人	白雪公主	雪姑七友
虫虫危机	虫虫特工队	虫虫危机
名侦探柯南：贝克街的亡灵	名侦探柯南：剧场版第6部	MeitanteiKonan:BekâSutorîtonobôrei
精灵鼠小弟	一家之鼠超力仔	一家之鼠
盒子怪	怪诞小箱侠	怪怪箱
龙之谷：破晓奇兵	龙之谷之黑龙崛起	龙之谷大电影
数码宝贝	数码暴龙	Digimon:DigitalMonsters
怪化猫	Mononoke
加菲猫	Garfield:TheMovie	加菲猫
小美人鱼	小鱼仙	小美人鱼3D版
十万个冷笑话	十万个冷笑话电影版	OneHundredThousandBadJokes
樱桃小丸子：来自意大利的少年	樱桃小丸子：从意大利来的少年	ChibiMaruko-chan:TheBoyfromItaly
ThunderboltFantasy东离剑游纪	东离剑游纪
摇滚藏獒	摇滚狗波迪	TibetanRockDog
云的彼端，约定的地方	云的彼端，约定之所	到云的那边再见
麦兜响当当	麦兜武当	麦兜故事4
亚人	亚人TV版
尸者帝国	TheEmpireofCorpses	Shishanoteikoku
听到涛声	海潮之声	听见涛声
恶童	恶童当街	Tekkonkinkreet
探险活宝第一季	探险活宝	探险时光
魔卡少女樱	百变小樱魔术卡	库洛魔法使
史努比：花生大电影	花生漫画大电影：史努比	史努比
通灵男孩诺曼	派啦诺曼：灵动小子	3D怪诞小学鸡
鲁滨逊漂流记	Robinson
奇特的故事	爱伦坡怪谈
心灵想要大声呼喊	好想大声说出心底话	心灵的呐喊
怪物史瑞克2	怪物史莱克2	史瑞克2
矶部矶兵卫物语
混沌武士	杂烩武士	琉球狂侍
哆啦A梦	机器猫	多啦A梦
食戟之灵	FoodWars:ShokugekinoSoma	ShokugekinoSoma
月刊少女野崎君	月刊少女野崎同学	月刊少女野崎
食戟之灵贰之皿	ShokugekinoSomaSeason2	食戟之灵第二季
罗小黑战记	TheLegendofLUOXIAOHEI
西游记	MonkeyKing
黑客帝国动画版	骇客帝国动画版
男子高中生的日常	DailyLivesofHighSchoolBoys
赛车总动员2	3D反斗車王2	Cars2：世界大赛
宠物小精灵	神奇宝贝	口袋怪兽
生命之书	曼罗奇遇记	神魔奇缘
火影忍者	狐忍	Naruto
中华小当家	中华一番之满汉传奇
蝙蝠侠：突袭阿卡姆	蝙蝠侠：入侵阿卡姆
四月是你的谎言	YourLieinApril	ShigatsuwaKiminoUso
那年那兔那些事第二季	那年那兔那些事儿第二季
暗芝居	Yamishibai
怪诞小镇第一季	怪诞小镇	GravityFalls
91天	ナイティワンデイス
丁丁历险记	丁丁历险记：独角兽号的秘密
猫汤	Nekojiru-so	CatSoup
辛普森一家	辛普森大电影	阿森一族大电影
夏目友人帐第三季	Natsume'sBookofFriends3	夏目友人帐第三季
乐高大电影	LEGO英雄传	乐高玩电影
昆虫总动员	微观小世界：失落的蚂蚁谷	虫虫大联盟：方糖争霸战
花园墙外	园墙之上	飞越院墙
蜡笔小新	蜡笔小新	KureyonShin-chan
夏目友人帐第二季	续夏目友人帐
钢之炼金术师	钢之炼金术师
人猿泰山	Tarzán
自杀专卖店	找死专卖店	嫌命长生店
反叛的鲁路修	CodeGeass反叛的魯路修	叛逆的魯魯修
腐男子高校生活
怪诞小镇第二季
死神和鹿	TheLifeofDeath
快乐的大脚	踢跶小企鹅	欢快的大脚
魔法少女小圆	Madoka★Magica	魔法少女魔户香
她和她的猫	SheandHerCat	TheirStandingPoints
仲夏夜魔法	奇异魔法	仲夏魔法夜
乡巴佬希尔一家的幸福生活第一季	一家之主第一季	山丘之王第一季
阿拉丁	阿拉丁历险记	阿拉丁
闪电狗	雷霆战狗	超级零零狗3D
怪物史瑞克3	怪物史莱克3	史瑞克3
科学怪狗	怪诞复活狗	科学怪犬
海绵宝宝	海绵宝宝：海陆大出击	海绵宝宝历险记：海绵出水
鼠来宝4：萌在囧途	鼠来宝4	鼠来宝：鼠喉大作赞
蓝精灵	蓝色小精灵	蓝精灵
瑞克和莫蒂第三季
早上好	Ohayo
舒克和贝塔	舒克与贝塔
最终幻想7：圣子降临	最终幻想7：归来之子	最终幻想7：降临之子
大都会	OsamuTezuka'sMetoroporisu	Metoroporisu
三个和尚	ThreeMonks
名侦探柯南：天空的遇难船	DetectiveConan:TheLostShipinTheSky
黑猫警长	HeiMaoJingZhang
永生之酒	为酒而狂	Baccano
天真与闪电	甜蜜稻妻	SweetnessandLightning
熊的故事	BearStory
海洋奇缘	莫阿娜	摩阿娜
夏目友人帐第四季	妖怪联络簿四	夏目友人帐Ⅳ
名侦探柯南：通向天国的倒计时	名侦探柯南2001：通向天国的倒计时	名侦探柯南：剧场版第5部
鸟鸟鸟	献给鸟儿们	鸟鸟鸟
暗夜恐惧	怕黑怪谈	怕黑怪谈录
意外的幸运签	多彩奇幻之旅	Karafuru
攻壳机动队第一季	攻壳机动队S.A.C.GhostintheShell:StandAloneComplex	攻壳机动队STANDALONECOM
银魂第二季	银魂第二季
宇宙快递	懒惰的快递员约翰	宇宙快递员
木偶奇遇记	匹诺曹	木偶奇遇记
苍蝇一分钟的生命	一分飞到挂	一分钟的飞行
暗杀教室	AssassinationClassroom	AnsatsuKyoushitsu
野良神第1季	流浪神差	Noragami
修剪草坪的小黄人
原始星球	神奇星球	奇幻星球
反叛的鲁路修R2	CodeGeass:LelouchoftheRebellionR2	叛逆的鲁路修R2
犬夜叉	Inuyasha	犬夜叉
一指城
樱桃小丸子	ChibiMaruko-chan	樱桃小丸子
公主与青蛙	青蛙公主	TheFrogPrincess
最终幻想15：王者之剑
极速蜗牛	极速TURBO	涡轮方程式
仙履奇缘	灰姑娘	辛德瑞拉
蓝雨伞之恋	小蓝伞	蓝雨伞
九色鹿	TheNine-ColoredDeer
大力水手第一季	Popeye	大力水手
文豪野犬	文豪StrayDogs
鬼牌游戏	代号D机关	JokerGame
麦兜，菠萝油王子	麦兜故事2	McDull,PrincedelaBun
怪兽屋	怪兽屋	怪兽小屋
和巴什尔跳华尔兹	与巴什共舞	与魔共舞
四驱兄弟	爆走兄弟	BakusouKyoudaiLet's&Go
脆莓公园第一季
名侦探柯南：世纪末的魔术师	名侦探柯南1999：世纪末的魔术师	名侦探柯南：剧场版第3部
名侦探柯南：异次元的狙击手	名侦探柯南：剧场版第18部	名侦探柯南：2014年剧场版
干物妹小埋	我家有个鱼干妹
名侦探柯南：沉默的15分钟	名侦探柯南2011：沉默的15分钟	DetectiveConan:QuarterofSilence
追逐繁星的孩子	ChildrenwhoChaseLostVoicesfromDeepBelow
正义联盟：闪点悖论
魁拔之十万火急	魁拔	Kuiba
名侦探柯南：漆黑的追踪者	名侦探柯南：漆黑的追迹者	名侦探柯南：剧场版第13部
七龙珠	龙珠	Dragonball
刺猬小子之天生我刺	天生我刺	BobbytheHedgehog
名侦探柯南：引爆摩天楼	名侦探柯南1997：引爆摩天楼	名侦探柯南：计时引爆摩天楼
名侦探柯南：第十四个目标	名侦探柯南1998：第14个目标	名侦探柯南：剧场版第2部
名侦探柯南：迷宫的十字路口	名侦探柯南：迷宫的十字路	名侦探柯南：剧场版第7部
猫的集会	15名动画人：猫的集会	Ani*Kuri15:AGatheringofCats
加菲猫2	加菲猫2·双猫记	加菲猫2之双猫记
十二生肖	十二生肖的故事
元气囝仔	Barakamon
我的邻居山田君	隔壁的山田君	邻居的山田君
南方公园	南方公园电影版	南方四贱客
名侦探柯南：侦探们的镇魂歌	名侦探柯南:侦探们的安魂曲	DetectiveConan:ThePrivateEyes'Requiem
命运之夜前传第一期	Fate	Zero第一期
王立宇宙军：欧尼亚米斯之翼	RoyalSpaceForce:WingsofHonneamise	ÔritsuuchûgunOneamisunotsubasa
十万个冷笑话第一季	Onehundredthousandbadjokes
海尔兄弟	HaierBrothers
魔方大厦
机器人9号	9：末世决战
无头骑士异闻录	毒辣辣辣	头丢啦啦啦
忧郁的物怪庵	不愉快的妖怪庵	怪物庵宝宝不开心
电焊工波力	Wall-E番外篇：电焊工
马男波杰克第四季
暴力云与送子鹳	局部多云	部分多云
神笔马良
海贼王2016剧场版	海贼王剧场版GOLD	海贼王特别篇：黄金之心
鸭子侦探
辛普森一家第一季	阿森一族第一季
腌黄瓜先生第二季
马男波杰克2014圣诞特辑：Sabrina的圣诞愿望	马男波杰克2014圣诞特辑
野良神第2季	野良神荒事	ノラガミ2期
星际宝贝	扮野小魔星	莉萝与史迪奇
乐高超级英雄：正义联盟之宇宙冲击	乐高超级英雄：正义联盟之宇宙冲击
暗杀教室第2季	章鱼老师	极速老师
星之声	星尘物语	VoicesofaDistantStar
小鸡快跑	咪走鸡	落跑鸡
银魂第三季	Gintama°
画江湖之不良人
变形金刚	变形金刚电影版
逗鸟外传：萌宝满天飞	送子鸟	BB宅急便
飞翔的魔女	FlyingWitch
大头儿子和小头爸爸
某人的目光	DarekanoManazashi	Someone'sGaze
今夕何夕	明日世界	未来世界
魔术师和兔子	魔术师与兔子	魔术师和兔子
名侦探柯南：瞳孔中的暗杀者	名侦探柯南：剧场版第4部	MeitanteiConan:Hitominonakanoansatsusha
樱兰高校男公关部	OuranHighSchoolHostClub	樱兰高校男公关部
南方公园第一季	南方四贱客	衰仔乐园
聪明的一休	一休和尚	聪明的一休
棋魂	光之棋	Hikarunogo
异邦人：无皇刃谭	Stranja:SwordoftheStranger	Sutorenjia:Mukôhadan
怪物史瑞克4	史力加万岁万万岁	史瑞克快乐4神仙
纸人	纸上谈情
没有宇宙我们无法生存	无宇宙，无生命	Minemozhemzhitbezkosmosa
魔神英雄传	神龙斗士	魔神英雄坛
加速世界INFINITEBURST	加速世界：无限超频
百日红	北斋小姐	さるすべり
命运之夜无限剑制	命运之夜UBW	命运之夜重制版
派珀历险记
101斑点狗	忠狗历险记	宝贝历险记
田中君总是如此慵懒
15名动画人	Ani*Kuri15	Anikuri15
名侦探柯南：战栗的乐谱	名侦探柯南2008：战栗的乐谱	柯南剧场版：战栗的乐谱
未来日记	TheFutureDiary	みらいにっき
越狱兔第一季	越狱兔子	监狱兔
来自新世界	自新世界	FromtheNewWorld
堕落的艺术	坠落的艺术	FallenArt
画之国
弹丸论破3-TheEndof希望之峰学园-未来篇	枪弹辩驳3
马丁的早晨	MartinMorning
极地特快	北极特快车	极地列车
精灵鼠小弟2	一家之鼠2	一家之鼠超力仔2
拽妹黛薇儿第一季	Daria:TheSeries
某科学的超电磁炮	科学超电磁炮	ToAruKagakunoRailgun
忍者神龟：变种时代	真人版忍者神龟	忍者龟：变种世代
绑架课
雪孩子	雪孩子——小兔淘淘的故事
名侦探柯南：银翼的魔术师	名侦探柯南剧场版第8部	ConanMovie8-MagicianoftheSilverSky
元气少女缘结神	KamisamaHajimemashita
名侦探柯南：水平线上的阴谋	名侦探柯南剧场版09：水平线上的阴谋	名侦探柯南2005年剧场版：水平线
名侦探柯南：远海的侦探	名侦探柯南：绝海的侦探	名侦探柯南：剧场版第17部
邋遢大王奇遇记
南方公园第十九季
乐高DC超级英雄：哥谭大越狱
阿童木	铁臂阿童木	原子小金刚
莱利的初次约会	头脑特工队番外短片：莱利的初次约会	莱利的第一次约会
福音战士新剧场版：序	Evangelion1.0YOUAREALONE	Evangerionshingekijôban:Jo
无翼鸟	几维鸟
光杆乐队	许愿池	单人乐队
人狼	JinRoh:TheWolfBrigade
爆笑虫子第一季	臭屁虫	LarvaSeason1
蓝皮鼠和大脸猫	蓝皮鼠和大脸猫第一部
名侦探柯南：第十一名前锋	名侦探柯南第16弹：第11位前锋	名侦探柯南：第11人的前锋
排球少年第一季	小排球
纽约屁民第一季	纽约浮牲录
如果动物界都是胖子	胖子的困扰	肥版国家地理
亲吻姐姐OAD	亲吻姐姐OVA
四叠半神话大系	四叠半宿舍，青春迷走	四叠半神话大系
冰雪奇缘：生日惊喜	冰雪奇缘：惊喜连连	魔雪奇缘：发烧狂热
美少女战士	美少女战士第一季	美少女戰士初代
飞天小女警第一季	CN原创之飞天小女警
狮子王3	狮子王1½	狮子王一又二分之一
天行九歌	秦时明月特别篇之心之逆鳞	天行九歌第一篇之心之逆鳞
LoveLive	明星学生妹	LoveLive校园偶像计划
飞出个未来第一季
攻壳机动队第二季	攻壳机动队S.A.C.2ndGIG	GhostintheShell:S.A.C.2ndGIG
K-project
王子与公主	PrincesandPrincesses	王子与公主
蝙蝠侠：红影迷踪	红帽兜下的蝙蝠	蝙蝠侠：红头罩之下
吹响悠风号	奏响吧上低音号
十字路口	CrossRoad
小姐与流浪汉	小姐与流氓
对话的维度	对话的面向	对话的尺度
罪恶王冠	GuiltyCrown
圣斗士星矢	圣斗士	KnightsoftheZodiac
新世纪福音战士剧场版：Air	真心为你	新世纪福音战士剧场版：咏叹调	真心为你	新世纪福音战士剧场版2
放屁吾郎	屁屁吾郎
查理和巧克力工厂	巧克力冒险工厂	朱古力奖门人
这个美术部有问题	这个美术社大有问题
远在天边	真我之旅	远在天边
麦兜·饭宝奇兵	麦兜·麦露宝	McDull·RiseofTheRiceCooker
我们诞生在中国	诞生于中国
事故、错误和灾难
虹猫蓝兔七侠传	Thestoryofhongmaoandlantu
十二国记	12kokuki	TheTwelveKingdoms
小飞侠	彼得潘	LesaventuresdePeterPan
打，打个大西瓜	SeeThrough
白箱
没头脑和不高兴
龙珠超	DragonBallSuper
福音战士新剧场版：破	Evangelion:2.0YouCanAdvance	EvangelionNewTheatricalVersion:Breaking
正义联盟：毁灭
镜花缘
天降美食2	美食风球2	食破天惊2
超能太阳鸭	鸭尊宝	Quackerz
命运石之门剧场版：负荷领域的既视感	剧场版斯坦因之门负荷领域的既视感	GekijōbanShutainzuGētoFukaRyōikino
小鹿斑比	WaltDisney'sBambi
地下幻灯剧画少女椿	地下幻灯剧画－少女椿
蒸汽男孩	蒸汽少年	Steamboy
兔子和鹿	rabbitanddeer
空中杀手	TheSkyCrawlers	空中骑士
名侦探柯南：深蓝色的海盗旗	名侦探柯南2007：蔚蓝色的灵柩	名侦探柯南：绀碧之棺
狮子王2：辛巴的荣耀	狮子王2	狮子王2：辛巴的荣耀
Gyo:TokyoFishAttack
四月一日灵异事件簿	四月一日灵异记事簿	次元魔女
魁拔Ⅲ战神崛起	魁拔3	魁拔3战神崛起
歌唱秀	星梦动物园	欢乐好声音
兽爪	Kemonozume
小蝌蚪找妈妈	BabyTadpolesLookforTheirMother
剧场版魔法少女小圆新篇叛逆的故事	PuellaMagiMadokaMagicatheMovie:Rebellion
命运之夜前传第二期	Fate	Zero第二期
攻壳机动队SSS	攻壳机动队S.A.C.SolidStateSociety	攻殻机动队3
超级无敌掌门狗：人兔的诅咒	酷狗宝贝4：人兔的诅咒	超级无敌掌门狗之世纪大骗兔
凉宫春日的消失	TheDisappearanceofHaruhiSuzumiya	SuzumiyaHaruhinoshôshitsu
中二病也要谈恋爱	中二病也想谈恋爱	ChuunibyouDemoKoigaShitai
森林战士	绿国奇兵	森林英雄
仓鼠管家	ebichu
新妹魔王的契约者	TheTestamentofSisterNewDevil	ShinmaiMaounoTestament
空之境界第一章俯瞰风景	空之境界电影版1：俯瞰风景	KaranoKyoukai:TheGardenofSinners
秦时明月之龙腾万里	秦时明月3D电影龙腾万里	秦时明月大电影之龙腾万里
好想告诉你	好想告訴你
兽兵卫忍风帖	NinjaScroll
姆明：漫游蓝湾	MoominsontheRiviera
松鼠，坚果和时间机器	松鼠穿越记	松鼠，坚果和时间机器
埃及王子	埃及王子
鬼灯的冷彻	HoozukinoReitetsu
世界第一初恋	世界第一的初恋	SekaiichiHatsukoi
俗世乐土第一季	俗世乐土	丑陋的美国人
驯龙高手番外篇：龙的礼物
半田君传说	元气囝仔外传
回转企鹅罐	转吧企鹅罐
颠倒的帕特玛	颠倒的帕蒂玛	帕蒂玛的颠倒世界
青春之旅	闪烁的青春	AoHaruRide
蝙蝠侠：黑暗骑士归来
画江湖之不良人II	画江湖之不良人第二季
团子大家族	クラナド
凉宫春日的忧郁	凉宫春日的忧郁	SuzumiyaHaruhinoYuuutu
花牌情缘	千早之歌	歌牌情缘
蜂蜜与四叶草	蜂蜜幸运草	蜂蜜与幸运草
佛兰德斯的狗	龙龙与忠狗	佛兰得斯的狗
化物语	Bakemonogatari
火影忍者剧场版：终章	火影忍者剧场版10：完结篇	GekijoubanNaruto:TheLast
小马王	小马精灵	Spirit
甲贺忍法帖	Basilisk:Kôganinpôchô
蓝猫淘气3000问	蓝猫淘气三千问
半梦半醒的人生	浪族色彩	梦醒十分
老雷斯的故事	罗雷司	绿野仙生
弹丸论破3-TheEndof希望之峰学园-绝望篇
雨之城
小松鼠之宇宙冒险	宇宙松鼠灾变	松鼠乱宇宙
命运之夜无限剑制第二季	命运之夜UBW第二季	命运之夜重制版第二季
秦时明月之君临天下	秦时明月第五部	秦时明月5
我的英雄学院	Bokunoheroacademia	MyHeroAcademia
搞笑漫画日和	GyaguMangaBiyori
冰河世纪：巨蛋恶作剧
寒蝉鸣泣之时	秋蝉鸣泣之时	Higurashinonakukoroni
动物农场	动物庄园
蓝精灵2	蓝色小精灵2
泰迪熊之玩具大战	ToysWar
怪兽在巴黎	巴黎怪兽	巴黎怪物
越狱兔第二季	越狱兔子	监狱兔
山中故事	MountainSpirits
弹丸论破：希望的学园和绝望高中生	ダンガンロンパ希望の学園と絶望の高校生	弹丸论破希望的学园和绝
铁甲小宝	铁甲小宝—卡布达
夏目友人帐第五季	Natsume'sBookofFriends5	夏目友人帐Ⅴ
超级恋人
白熊咖啡馆	北极熊café	白熊咖啡厅
桃花源记	TheLegendofShangri-la
乐高蝙蝠侠大电影：DC英雄集结	乐高蝙蝠侠大电影
爆笑虫子第二季	臭屁虫2	LarvaSeason2
弦槌	HAMMERHEAD	日本アニメ見本市第25話
哪吒传奇
穿靴子的猫：萌猫三剑客	穿靴子的猫之萌猫三剑客	穿靴子的猫：三只大菠萝
小糊涂神	小糊涂神
死神	Bleach
睡美人	睡公主	Labelladurmiente
宠物小精灵：超梦的逆袭	宠物小精灵：超梦的反击	神奇宝贝：超梦的逆袭
轻音少女	轻音	K-On
卑鄙的我2番外篇：宠物	DespicableMe2MiniMovie:Puppy
忍者神龟2：破影而出	忍者龟：魅影突击	忍者龟：破影而出
勇者大冒险	勇者大冒险之黄泉手记
黑子的篮球	影子篮球员	幻影篮球王
探险活宝第三季
正义联盟：战争
亚尔斯兰战记	阿斯兰战记	ArslanSenki
圆梦巨人	吹梦巨人	好心眼儿巨人
哈布洛先生
探险活宝第二季	AdventureTimewithFinn&Jake
一拳超人OVA6	不可描述的杀人事件	TheMurderCaseThatIsTooImpossible
国王与小鸟	國王與鳥	TheKingandtheMockingbird
蝙蝠侠：元年	蝙蝠侠：元年
山水情	FeelingsofMountainsandWaters
葫芦小金刚	葫芦兄弟第二部	葫芦娃第二部
全职猎人2011	新全职猎人
龙与虎	虎X龙
头文字D新剧场版：梦现
大盗贼	DerRäuberHotzenplotz
霍顿与无名氏	霍顿奇遇记	大象亚钝救细界
足球小将	足球小将（昭和版）	天使之翼
鼠来宝：明星俱乐部	鼠来宝2	艾尔文与花栗鼠2
无头骑士异闻录第二季：结OVA	DuFuFuFu
超人与蝙蝠侠：公众之敌
坂道上的阿波罗	KidsontheSlope
狐妖小红娘
哆啦A梦：大雄的秘密道具博物馆	哆啦A梦2013剧场版	Doraemon:NobitanoHimitsuDōguMuseum
网球王子	Tenisunoôjisama	PrinceofTennis
热诚传说X	情热传说X	TalesofZestiriatheX
JOJO的奇妙冒险星尘斗士	JOJO的奇妙冒险星尘十字军	JOJO的奇妙冒险TV版第二季
我的青春恋爱物语果然有问题	果然我的青春恋爱喜剧搞错了	大春物
悲伤的贝拉多娜	KanashiminoBeradona	BelladonnaofSadness
小黄人番外篇：比赛	小黄人番外篇1
秦时明月之诸子百家	秦时明月3
秋日天空OAD	秋色之空OAD
福音战士新剧场版：Q	福音战士新剧场版：急	Evangelion3.0YOUCANREDO
探险活宝第四季
圣斗士星矢	圣斗士星矢：圣域传说	SaintSeiya:LegendofSanctuary
犬夜叉：完结篇	InuYasha:Kanketsu-hen	InuYasha:TheFinalAct
空之境界第二章杀人考察（前）	空之境界电影版2：杀人考察	GekijôbanKaranokyôkai:Dainishô-Satsujin
无头骑士异闻录第二季：结	无头骑士异闻录×2
顽皮跳跳灯	小台灯	KleineLampe,Die
蜡笔小新：决一胜负逆袭的机器人爸爸
茶啊二中第1季
血界战线	幻界战线	KekkaiSensen
攻壳机动队2.0	GhostintheShell2.0	Kôkakukidôtai2.0
鼹鼠的故事	小鼹鼠妙妙奇遇记	小鼹鼠
High☆Speed-FreeStartingDays-	Free剧场版
生化危机：诅咒	Biohazard:Damnation	ResidentEvil:Damnation
蓝精灵第一季	蓝精灵的世界	Smurfs'Adventures
星游记第二季	星游记重制版	星游记网络大电影
秦时明月之夜尽天明	秦时明月2
明美的初恋
空山鸟语	秦时明月特别篇之空山鸟语	秦时明月空山鸟语特别篇
猴子捞月
机器人历险记	机器世代	露宝治的世界
寻找隐世快乐	TheArtofHappiness
海绵宝宝第一季
橘色奇迹	オレンジ
滑头鬼之孙千年魔京	滑头鬼之孙第二季
秦时明月之万里长城	秦时明月4
致梵高的爱	至爱梵高	探索梵高的生与死
为什么猫都叫不来	猫咪去哪儿	CatsDon'tComeWhenYouCall
下流梗不存在的灰暗世界	没有黄段子的无聊世界
名侦探柯南：江户川柯南失踪事件～史上最惨的两天～	名侦探柯南：20周年动画特别篇
有顶天家族	UchoutenKazoku	TheEccentricFamily
一拳超人OVA1	过于鬼祟接近的影子	TheShadowThatSnuckUpTooClose
一万年以后	天籁：一万年以后	10000YearsLater
如此美好的一天
她的回忆	Kanojonoomoide	MagneticRose
单曲人生	一曲人生	独身生活
别了武器	武器再见
数码宝贝2	数码暴龙2	数码宝贝大冒险2
暗芝居第二季
纯情罗曼史	纯情罗曼史
脆莓公园第三季
钢琴之森	森林中的钢琴师	钢琴森林
玩具总动员：遗忘的时光	玩具总动员：迷失时空	玩具总动员：被遗忘的时光
日在校园	SchoolDays
境界的彼方	KyoukainoKanata
豚鼠特攻队	超鼠特攻	鼠胆妙算
星银岛	星空夺宝	宝藏星球
特别的她	求恋期	FoolyCooly
一拳超人OVA5	关系复杂的姐妹	TheSistersWhoHaveTooManyThingsHappening
天才嘉年华	创世峰会	ジーニアス・パーティ
死亡游行	死亡游戏	DeathParade
新葫芦兄弟第一季	CalabashBrothersⅡ
挑战者联盟	足球小小将	桌面足球
LoveLive第二季	明星学生妹Ⅱ	LoveLive校园偶像计划第二季
排球少年第二季	排球第二季
暗芝居第三季	Yamishibai
快乐的大脚2	3D踢哒小企鹅2	快乐脚2
编舟记	TheGreatPassage	编舟记动画版
当风吹起的时候	Agdyzawiejewiatr	Quandosoffiailvento
K第二季	K诸王归来
战鸽总动员	战鸽快飞	空中勇士
南郭先生
护花使者
JOJO的奇妙冒险星尘斗士埃及篇	JoJo'sBizarreAdventure:StardustCrusaders:BattleinEgypt	JoJonoKimyounaBouken:Stardu
一拳超人OVA2	话多的弟子	ThePupilWhoIsanExtremelyPoorTalker
一拳超人OVA3	蛋疼的忍者	TheNinjaWhoIsTooComplicated
别惹蚂蚁	联合缩小兵	小蚁霸
昭和元禄落语心中OAD：与太郎放浪篇
玉子爱情故事	玉子市场剧场版	TamakoLoveStory
某科学的超电磁炮S	某科学的超电磁炮第二季	科学超电磁炮S
地海传说	地海战记	地海传奇之格德战记
剑风传奇黄金时代篇1：霸王之卵	剑风传奇剧场版	Beruseruku:OugonjidaihenI-Haounotamago
捉迷藏	鬼街御常夜	KAKuRenBo
长发公主番外篇：麻烦不断	麻烦不断	魔发奇缘之后
飞天小女警	霸王美少女	ThePowerpuffGirls:TheMovie
蝙蝠侠：血脉恩仇	蝙蝠侠：势不两立	蝙蝠侠：家庭不和
青之驱魔师	蓝色驱魔师
夜幕下的故事	夜幕下的物语	枕边故事
恶搞之家第一季	搞怪一家人第一季	格利芬一家第一季
鼠来宝	艾尔文与花栗鼠	花鼠明星俱乐部
银魂剧场版：新译红樱篇	Gintama:TheMovie	GekijoubanGintama:Shin'yakubenizakurahen
名侦探柯南OVA9：十年后的陌生人	DetectiveConanOVA9:Strangersin10Years
最终幻想	太空战士之灭绝光年	公主蒙难记
亚特兰蒂斯：失落的帝国	失落帝国	迷失帝国：阿特兰蒂斯
冰河世纪：猛犸象的圣诞	冰河世纪番外篇：圣诞节倒计时
黄色潜水艇	黄色潜艇	黄色的潜水艇
剑风传奇	烙印战士	Berserk
日常工作第一季	天兵公园	日常参考
成龙历险记第一季
一拳超人OVA4	强硬无比的邦古	Bang,WhoIsTooOverbearing
空之境界第三章痛觉残留	空之境界电影版3：痛觉残留	GekijôbanKaranokyôkai:Daisanshô-Tsukakûzan
收发室惊魂	卑鄙的我2番外篇：收发室惊魂	DespicableMe2MiniMovie:PanicintheMailroom
邻座的怪同学	TonarinoKaibutsu-kun
脆莓公园第二季
荒川爆笑团	荒川爆笑团第一部
小飞象	小象丹波	DumbotheFlyingElephant
功夫熊猫之盖世五侠的秘密	功夫熊猫：盖世五侠的秘密
加速世界	AccelWorld
星际牛仔：天国之门	赏金猎人：天国之扉	CowboyBebop:TheMovie
浪客剑心：追忆篇	浪客剑心之追忆篇	浪客剑心明治剑客浪漫谭：追忆编
花牌情缘2	歌牌情缘2
黑塔利亚	百无一用意呆利	废柴意大利
机动战士高达：雷霆宙域	MobileSuitGundamThunderbolt
宇宙巡警露露子	SpacePatrolLuluco
丹麦诗人	丹麦诗人
神奇飞书	莫里斯·莱斯莫先生的神奇飞书
我叫MT之山口山战记	我叫哀木涕之山口山战记	我叫MT之勇士战恶龙
JOJO的奇妙冒险TV版	JOJO的奇妙冒险	ジョジョのきみょうなぼうけん
火影忍者疾风传	NarutoShippuuden
线上游戏的老婆不可能是女生
眷恋你的温柔	ハイブリッドチャイルド
世界第一初恋2	世界第一初恋第二季
亚瑟和他的迷你王国	亚瑟和迷你王国	亚瑟和迷你墨王国
魁拔之大战元泱界	魁拔II	魁拔2
鲨鱼黑帮	鲨鱼故事	鲨鱼传说
元气少女缘结神第二季	神様はじめました2期
海绵宝宝历险记	棉球方块历险记	海绵宝宝历险记
江户盗贼团五叶	SaraiyaGoyou	HouseofFiveLeaves
风中奇缘	Pocahontas-OEncontrodeDoisMundos	Покахонтас
种下星星的日子	购买星星之日	TheDayICroppedaStar
夏洛特的网	篱笆墙外	夏洛的网
正义联盟：两个地球的危机	正义联盟：两面夹击
爱丽丝梦游仙境	Aliceaupaysdesmerveilles
蝙蝠侠：黑暗骑士归来
天使的心跳	天使的脉动
鼠来宝3	花鼠明星俱乐部	艾尔文与花栗鼠3-3D
亚人1：冲动	亚人剧场版1
铳墓	枪冢	枪墓
斗龙战士之星印罗盘	Compass
忍者神龟	忍者龟2007	忍者龟：旋风再起
空之境界第五章矛盾螺旋	空之境界电影版5：矛盾螺旋	GekijôbanKaranokyôkai:Daigoshô-Mujunrasen
杀戮都市：O	ガンツオー
食梦者	爆漫王	爆漫
全金属狂潮	惊爆危机	FullMetalPanic
我的妹妹哪有这么可爱	我的妹妹不可能这么可爱	Orenoimoutogakonnanikawaiiwakeganai
虫师续章	虫师第二季	Mushishi:Zoku-Sho
哆啦A梦	旧哆啦	机器猫
猫头鹰王国：守卫者传奇	守卫者传奇	猫头鹰守护神
白兔糖	兔子软糖
未来学大会	动漫影后	虚拟天后
元气少女缘结神：过去篇	元气少女缘结神OVA：过去篇
太空丹迪	宇宙浪子	SpaceDandy
忍者神龟	TeenageMutantHeroTurtles	忍者神龟
蝙蝠侠之子
斩·赤红之瞳	斩赤红之瞳	AkamegaKiru
浪客剑心	浪客剑心
魔神坛斗士	鎧傳	铠传——武士军团
秦时明月之百步飞剑	QinsmoonI	秦时明月1
首尔站	SeoulStation
生化危机：恶化	ResidentEvil:Degeneration	ResidentEvilCG
小黄人番外篇：不消停的宾齐·尼尔森	小黄人番外篇3	不安分的小尼尔森
团子大家族第二季	团子大家族2	クラナドアフターストーリー
阿凡提的故事之卖树荫	第一集：卖树荫
辅助轮	卑鄙的我2番外篇：辅助轮	DespicableMe2MiniMovie:TrainingWheels
神笔马良	TheMagicalBrush
风云决	StormRider	StormRider:ClashofEvils
攻壳机动队新剧场版	GhostintheShell:TheNewMovie
阿尔卑斯山的少女	飘零燕	小天使
守坝员	看守风车的猪
格雷少年	驱魔少年	D.Gray-man
阿拉蕾	IQ博士	怪博士与机器娃娃
我为歌狂
家庭大改造	卑鄙的我番外篇：家庭大改造	装饰房子
GANGSTA匪徒	黑街	ギャングスタ
亚人OAD	亜人OAD
黑礁	企业佣兵
吸血鬼仆人
少年同盟	你和我第一季	少年同盟第一季
猫在巴黎	巴黎夜猫	猫的生活
夏目友人帐：曾几何时下雪之日	有朝一日暮雪时
灵异E接触	灵异E接触	LEVELE
青之文学	青涩文学
双斩少女	斩服少女	KillLaKill
地狱少女	JigokuShoujo
初恋monster	初恋怪兽
茶啊二中第2季
和歌子酒	和歌子酒动画版
大草原上的小老鼠	LittleMouseonthePrairie
哈哈镜花缘
曹冲称象	CaoChongChengXiang
空中大灌篮	太空也入樽	怪物奇兵
地狱归来	Hell&Back
哆啦A梦：大雄的恐龙	哆啦A梦06剧场版：大雄的恐龙	Doraemon:Nobita'sDinosaur
命运之夜	Fate	staynight	命运守护夜
关于完全听不懂老公在说什么的事	不知道丈夫在说什么的事情	关公说事
逆转裁判对这个“真实”有异议	逆转裁判动画版
滑头鬼之孙	妖怪少爷	百鬼小当家
天上掉下个猪八戒
蜜蜂总动员	蜜蜂电影	蜂电影
大护法之黑花生
一拳超人：英雄之路	一拳超人OAD	OnePunchMan:RoadtoHero
变身国王	国王的新装	皇帝的新装
家庭教师	KatekyoHitmanReborn	家庭教師REBORN
钢铁巨人	铁巨人	大铁人
魔动王	光能使者	大无敌
海贼王剧场版10：强者天下	海贼王剧场版第10弹
大歌唱家	Maestro	歌唱家
鲁邦三世VS名侦探柯南	RupanSanseivsMeitanteiConan
文森特
哆啦A梦：大雄的宇宙英雄记	DoraemonNobitaandtheSpaceHeroes
老人与海	老人と海
南方公园第十一季	衰仔乐园第十一季	南方四贱客第十一季
丁丁历险记第一季	LesAventuresdeTintin
我们仍未知道那天所看见的花的名字剧场版	未闻花名剧场版	那朵花
冬之蝉	冬之蝉
飞机总动员	飞机总动员
拽妹黛薇儿第二季
粉红猪小妹第一季	小猪佩琦	小猪佩奇
蜡笔小新：我的搬家物语仙人掌大袭击
会长是女仆	会长是女仆大人	学生会长是女仆
月刊少女野崎君特典
樱子小姐的脚下埋着尸体
代号D机关SP1	鬼牌游戏	代号D机关
成年女性的动画时间	熟女的时间
傻大猫和崔弟第一季	阿宝翠儿历险记
围棋少年
十万个冷笑话第三季
铁臂阿童木	原子小金刚	Tetsuwanatomu
金猴降妖	孙悟空三打白骨精
天堂之吻	パラダイスキス
少年同盟2	你和我第二季	少年同盟第二季
商标的世界	商标大电影	Logo的世界
丛林大反攻	打猎季节	森林反恐队
花木兰2	Mulan2-ALendaContinua
银之匙	白银之匙	SilverSpoon
佝偻猫	旋旋喵	来来猫
探险活宝第五季
三个发明家	TheThreeInventors
电脑线圈	电脑COIL	电脑线圈
野球少年	Battery	投捕搭档
篱笆墙外	飞跃篱墙	篱墙之战
石膏男孩	石膏Boys
啄木鸟伍迪	调皮啄木鸟
红白黑黄第三季
纯情罗曼史2
幽游白书	幽游白书
魔法阿妈	Mofaama	GrandmaandHerGhosts
小贝流浪记	猫咪小贝
银之匙第二季	白银之匙第二季	SilverSpoonSeason2
夏娃的时间	TimeofEve
太阳之子
铁胆火车侠	电光快车侠	JapanHikarianRailroad
空之境界第四章伽蓝之洞	空之境界电影版4：伽蓝之洞	GekijôbanKaranokyôkai:Daiyonshô-Garannodô
LoveLiveSunshine	LoveLiveSunshine
在家的杀戮时光
惊恐小镇	惊悚镇	小村吓吓叫
魔发精灵	丑娃	巨魔
女娲成长日记
超人与蝙蝠侠：启示录
剑风传奇黄金时代篇3：降临	剑风传奇剧场版	Berserk:Ohgonjidaihen3-Kôrin
星空清理者	PlanetES
美国战队：世界警察	环球特警组	T.A.反恐战队
间之楔	AiNoKusabi
召唤恶魔阿萨谢尔	召唤恶魔	You'reBeingSummoned,Azazel-san
我嫁了个怪蜀黍	我嫁了一个怪物
钢之炼金术师：香巴拉的征服者	鋼之鍊金術師：香巴拉的征服者	FullmetalAlchemist-ConquerorofShamballa
越狱兔第三季	越狱兔子	监狱兔
乐园追放	RakuenTsuiho	ExpelledFromParadise
无头骑士异闻录第二季：转	无头骑士异闻录×2
八尾猫
魔法禁书目录	某魔术的禁书目录	传说中魔术的禁书目录
小黄人番外篇：疯狂小黄人	小黄人番外篇2	原始人的保姆
幻想曲2000	Fantasia2000
BABYBLUE
萨满的日常
甘城光辉游乐园	甘城辉煌乐园救世主	AmagiBrilliantPark
苍之茧	记忆裂痕	苍白的蓝
幻想曲	TheConcertFeature	Fantajia
狼少女与黑王子	OokamiShoujotoKuroOuji	WolfGirlandBlackPrince
李献计历险记	OTAKU之恋	Lee'sAdventures
神偷奶爸3	卑鄙的我3	神偷奶爸3之小小兵
怪老头儿	怪老头系列：怪老头儿
头朝下的生活
蜂蜜与四叶草II	Honey&CloverII	蜂蜜与四叶草2
玲音	SerialExperimentsLain
探险活宝第七季	探险时光
南方公园第八季	衰仔乐园第八季	南方四贱客第八季
南方公园第七季	衰仔乐园	南方四贱客
少年正义联盟第一季	少年正义联盟
吸血鬼骑士	吸血鬼騎士	Vanpaianaito
克里蒂，童话的小屋	克里蒂，房子的故事	老奶奶的魔法小屋
蜡笔小新之呼风唤雨大人帝国的反击	蜡笔小新之呼风唤雨大人帝国的反击
短暂和平	ショート・ピース
功夫熊猫之卷轴的秘密
黑子的篮球第二季
红白黑黄第一季
天使之卵	Angel'sEgg	Tenshinotamago
JOJO的奇妙冒险不灭钻石	东方仗助-浪漫伝奇-深红の秘伝说―	JoJonoKimyonaBoken:Diamondisunbreakable
魔装学园H×H	Hybrid×HeartMagiasAcademyAtaraxia	MasouGakuenHxH
谁陷害了兔子罗杰	梦城兔福星	威探闯通关
圣哥传	SaintOniisan	SaintYoungMen
我的小马驹：友谊大魔法第一季	我的小马驹:友谊的魔力	彩虹小马
飞出个未来第三季
丑小鸭	丑小鸭
熊出没之熊心归来	熊出没大电影3	BoonieBearsIII
迷宫物语	迷宫物语	LabyrinthTales
大陆之所以漂移	小松鼠之大陆分裂	大陆漂移的原因
ANIMA
Ayakashi
飞跃巅峰2	飞越颠峰2	勇往直前2
黑子的篮球第三季
三只小猪	三只小猪
一发失误S	网球双飞物语S	FaultService:AratanaruRival
影鳄第二季
我的朋友很少	Bokuwatomadachigasukunai	IDon'tHaveManyFriends
命运石之门：横行跋扈的浪荡之徒	命运石之门第25话	命运石之门TV未放送话
樱花庄的宠物女孩	樱花庄的宠物女孩	SakurasounoPetnaKanojo
爆笑虫子第三季	臭屁虫第三季	LarvaSeason3
超级无敌掌门狗：面包与死亡事件	酷狗宝贝5：面包与死亡事件	超级无敌掌门狗之面包和死亡事件
东之伊甸	东之伊甸	东方伊甸园
剑豪生死斗	剑豪生死斗	Shigurui
迪迦奥特曼	超人迪加	迪迦·奥特曼
翡翠森林：狼与羊	暴风雨之夜	狼羊物语
奇诺之旅	KinonoTabi:theBeautifulWorld	キノの旅:theBeautifulWorld
水星领航员第1季	水星领航员	水星领航员第一季
摩登原始人第一季	弗林特斯通一家	聪明笨伯
赌博默示录	逆境无赖KAIJI	逆境无赖开司
超级维纳斯
空之境界终章空之境界	空之境界终章
某个旅人的日记	TheDiaryofTortovRoddle
电风扇和花	风扇与花儿	当风扇爱上花
古城荆棘王	IbaranoO	KingofThorn
呼唤传说跳吧朋友	蜡笔小新剧场版森巴入侵计划	第14部剧场版
轻音少女第二季	轻音少女2	K-ON
拽妹黛薇儿第三季
黑塔利亚第2季	百无一用意呆利第2期	AxisPowers第2期
十万个冷笑话第二季
魔卡少女樱剧场版	魔卡少女樱剧场版香港篇	CardCaptorSakura:TheMovie-DieReisenachHongkong
魔卡少女樱剧场版：被封印的卡片	库洛魔法使剧场版被封印的卡片	CardCaptorSakura:TheMovie-TheSealedCard
哆啦A梦：大雄与奇迹之岛	电影多啦A梦-大雄与奇迹之岛	大雄与奇迹之岛~动物历险记~
妖狐×仆SS	妖狐X僕SS
寄生魔偶	寄生魔偶
轻音少女剧场版	K-ON劇場版
南方公园第十季	衰仔乐园第十季	南方四贱客第十季
禁忌咒纹	TabooTattoo
乐高DC超级英雄：正义联盟之末日军团的进攻	乐高正义联盟：毁灭军团来袭
星游记第一季	星游记第一季
秦时明月特别篇之帝子降兮	秦时明月之帝子降兮
可塑性记忆	PlasticMemories
南方公园第十五季	衰仔乐园第十五季	南方四贱客第十五季
消失的松果	消失的坚果	消失的橡果
夏洛特
苹果核战记	Appurushîdo	Appleseed
飞跃巅峰	飞越颠峰	勇往直前
未来都市NO.6	未來都市NO.6
冰菓OAD	冰果第11.5话
少年师爷之大禹宝藏
101真狗	101斑点狗	101只黑斑狗
正义联盟大战少年泰坦
四眼天鸡	四眼鸡丁	鸡仔总动员
猫物语	Nekomonogatari
钢之炼金术师四格剧场	Hagaren4KomageJijyou	钢炼四格剧场
变形金刚第一季	变形金刚
毁灭的发明	ADeadlyInvention	恶魔的发明
少女与战车剧场版	天才战车少女剧场版	GIRLSundPANZER剧场版
监狱学园OAD：疯狂的蜡	监狱学园OAD	MadWax
银魂完结篇：直到永远的万事屋	银魂完结篇剧场版：永远的万事屋	Gintama:TheFinalMovie
粗点心战争	粗点心战争	粗点心之战
昼与夜	阳光昼与阴郁夜	白天与夜晚
锡铁小兵	锡玩具
苹果核战记：阿尔法	アップルシードアルファ
少女革命	ShôjokakumeiUtena	RevolutionaryGirlUtena
抢劫坚果店	坚果行动	古惑松鼠之饥饿任务
阿赫迈德王子历险记	阿基米德王子历险记	TheAdventuresofPrinceAchmed
搞笑漫画日和3	搞笑漫画日和第3期	搞笑漫画日和3
飞出个未来大电影1：班德大行动	飞出个未来2007大电影	TheFuturamaMovie
野蛮人罗纳尔
阿凡提的故事之种金子	阿凡提的故事前传之种金子
圣斗士星矢：冥王哈迪斯十二宫篇	圣斗士星矢:冥王十二宫篇	SaintSeiya:TheHadesChapter-Sanctuary
飞哥与小佛的时空大冒险	飞哥与小佛：超时空之谜
交响情人梦	如歌般的野田妹	交响情人梦
探索者的羽翼
超神学院第3季：神与神	LOL
火影忍者剧场版：忍者之路	火影忍者剧场版第9弹	劇場版NARUTO-ナルト-ロード・トゥ・ニンジャ
夏雪密会	夏雪密会
再见，绝望先生	SayonaraZetsubou-Sensei	再见绝望老师
纯情罗曼史3	纯情罗曼史第三季
侦探的故事	侦探的故事	黑客帝国动画版
我的妹妹哪有这么可爱第二季	我的妹妹不可能这么可爱2
K剧场版
热带雨林的爆笑生活	HareGuu	热带雨林的爆笑生活
飞出个未来第二季
剑风传奇	剣风伝奇	烙印战士
火影忍者疾风传剧场版：鸣人之死	火影忍者剧场版疾风伝鸣人之死	火影忍者剧场版4疾风传：鸣人之死
火鸡总动员	火鸡反击战	时光鸡大作战
春田花花同学会	麦兜故事3	春田花花幼稚园
希德尼娅的骑士	银河骑士传	KnightsofSidonia
南方公园第十八季	衰仔乐园第十八季
食梦者第三季	爆漫王3	爆漫3
南方公园第十七季
喜羊羊与灰太狼	PleasantGoatandBigBigWolf
发条精灵战记天镜的极北之星
爷爷的煤油灯	爷爷的油灯	爷爷的灯
蜡笔小新：奇异乐园大冒险
妄想学生会	StudentCouncilStaffMembers	SeitokaiYakuindomo
奥林匹斯星传	希腊封神榜	奥林匹斯星传
虫师：蚀日之翳	虫师特别篇：蚀日之影	MushishiTokubetsu-hen:Hihamukage
星蝶公主第一季	公主闯天关
某科学的超电磁炮OVA	科学超电磁炮OVA	ToaruKagakunoRailgunOVA
勇者大冒险第二季
打工吧魔王大人
越狱兔前传	越狱兔第0季	UsavichZero
超人之死	超人之死
为什么猫都叫不来	猫よん
男子高中生的日常特典
三只小孤儿猫	三只小孤儿猫
皮克斯的故事	皮克斯传奇	皮克斯总动员
妖精的尾巴	FairyTail
花开伊吕波	HanasakuIroha	鲜花盛开的色彩
关于完全听不懂老公在说什么的事第二季	关公说事第二季
漫游者
丛林有情狼	野狼历险记	阿尔法与欧米加
银仙	电波少女与钱仙大人	GugureKokkuri-san
尸鬼	Shiki
火影忍者剧场版：大激突幻之地底遗迹	大激突幻之地底遗迹	火影忍者剧场版第二弹
蓝宝石之谜	海底两万里	不可思议的海之娜蒂亚
伪物语	Nisemonogatari
2077日本锁国	Vexille	Bekushiru:2077Nihonsakoku
跳跳羊
小杰克的攻击
地球防卫少年	ぼくらの	地球防卫少年
黑塔利亚第3季	百无一用意呆利第3季	黑塔利亚第3季
S·A特优生
魍魉之匣	MouryouNoHako
路人女主的养成方法	不起眼女主角培育法	SaenaiHeroineNoSodatekata
越狱兔第五季	普京兔和基里连科兔第五季	监狱兔
搞笑漫画日和2
银河英雄传说	HerdensagenVomKosmosinsel	银河英雄传说
哆啦A梦：新·大雄的大魔境	哆啦A梦新·大雄的大魔境贝可与5人探险队	哆啦A梦新·大雄的大魔境
汽车人总动员	TheAutobots
千年狐	狐狸雨	五尾狐
大战外星人	怪兽大战外星人	异形战魔怪
希德尼娅的骑士第二季第九惑星战役	银河骑士传第二期	KnightsofSidoniaBattleforPlanetNine
想做熊的孩子	男孩变成熊	熊孩子
老虎和兔子	基友英雄传	老虎和兔子
小精灵灰豆
OVERLORD	不死者之王	Overlord
熊出没之雪岭熊风	熊出没大电影2	BoonieBears:MysticalWinter
墓王之王	麒麟决
蝙蝠侠：哥谭骑士	蝙蝠侠：高登骑士	蝙蝠俠：高谭騎士
像素入侵	像素：复古游戏	像素入侵纽约城
悠哉日常大王	悠悠哉哉少女日和	哝哝日和
文子的告白	文子的告白
数码宝贝4：无限地带
机动战士高达雷霆宙域DECEMBERSKY	雷霆宙域战线剧场版
水果篮子	水果篮子
裸体哈维闯人生	哈維的一生	裸体哈维闯人生
银魂OAD爱染香篇（前篇）	爱染香前篇
宠物小精灵XY	口袋妖怪XY	神奇宝贝XY
终物语	Owarimonogatari
天体战士	天体战士桑雷德	AstroFighterSunred
物语系列第二季	物语系列2ndseason
银魂第二季延长篇	银魂‘延长战	金魂
皇家国教骑士团OVA	地狱之歌	厄夜怪客
京剧猫	BeijingOperaCats
蜡笔小新呼风唤雨战国大合战	TheStormCalled:TheBattleoftheWarringStates
猫屎一号	越战狂想曲	反斗兔兵
黑之契约者	黑之契约者	KuronoKeiyakusha
飞出个未来第六季	飞出个未来
妖兽都市	WickedCity	SupernaturalBeastCity
最后的吸血鬼
空之境界第七章杀人考察（后）	空之境界电影版7：杀人考察	GekijôbanKaranokyôkai:Satsujinkôsatsu
蠢蠢的死法
天线宝宝	天线得得B
老妇人与死神	老太太与死神	老妪与死神
南方公园第五季	衰仔乐园第五季	南方四贱客第五季
南方公园第四季	衰仔乐园第四季	南方四贱客第四季
南方公园第二季	衰仔乐园第二季	南方四贱客第二季
四驱兄弟II	四驱兄弟II
好想告诉你第二季	kiminitodoke
鸭子的生活	DibetagurashiAhirunoSeikatsu	Itislivinghappilyongroundeveryday
夏目友人帐：猫咪老师首次变身使者	夏目友人帐猫咪老师首次变身使者	夏目友人帐猫咪老师与初次跑腿
学园孤岛	SCHOOL-LIVE	GakkouGurashi
新鲜鳄梨酱	鳄梨色拉
食梦者第二季	爆漫王2	爆漫2
战神金刚：传奇的保护神
雪宝的鼻子	冰雪奇缘番外短片
冤罪	冤罪einefalscheBeschuldi-gung
干物妹小埋OAD	HimoutoUmaru-chanOAD	干物妹小埋TV未放送第13话
龙珠Z	DragonBallZ:Doragonbôruzetto	龙珠Z
少女与战车	GIRLSundPANZER	天才战车少女
火影忍者剧场版：大活剧雪姬忍法帖	火影忍者：雪姬忍法帖	NARUTOtheMoive:SnowPrincess'BookofNinjaArts
哆啦A梦：大雄与龙骑士	Doraemon:NobitatoRyûnokishi
哆啦A梦：大雄的日本诞生	哆啦A梦：大雄与日本诞生	Doraemon:NobitanoNihontanjô
哆啦A梦：大雄与云之国	哆啦A梦：大雄的梦幻王国	Doraemon:NobitatoKumonoôkoku
鲁邦三世VS名侦探柯南剧场版	雷朋三世VS名侦探柯南剧场版	Lupinthe3rdvs.DetectiveConan:TheMovie
全金属狂潮2	全金属狂潮校园篇
小美人鱼2：重返大海	小美人鱼2：重返大海
灵契	鬼契	灵鬼在线
蜡笔小新超时空呼风唤雨的我的新娘	蜡笔小新超时空呼风唤雨的我的新娘
混凝土革命超人幻想	ConcreteRevolutio超人幻想
魔法总动员	魔法之家	魔幻奇屋
东京地震8.0	TokyoMagnitude8.0	东京里氏8.0
降世神通第三季	降世神通：最后的气宗第三季火之书	降世神通：最后的气宗第三季
恶之华	恶之花	FlowersofEvil
我们这一家	我们这一家
追踪长尾豹马修	追踪马苏比拉米	沿着马苏比拉米的脚印
驯龙高手3	驯龙记3
奇可和丽塔	奇可与丽塔	ChicoandRita
机动警察剧场版1	机动警察PATLABOR剧场版	机动警察剧场版：东京毁灭战
怪鸭历险记第一季	怪鸭历险记第一季
世界纪录	世界纪录	黑客帝国动画版
我的青春恋爱物语果然有问题第二季	やはり俺の青春ラブコメはまちがっている2期
马达加斯加的企鹅：僵尸企鹅就是我
驱魔少年圣徒	新驱魔少年	D.Gray-man
幻想魔传最游记	最游记第一部	GensomadenSaiyuki
变形金刚：猛兽侠	BeastMachines:Transformers	BeastMachines
失物招领	迷失之物	丢了的东西
魔术快斗1412	怪盗基德1412
大力水手	PopeyetheSailor
海贼王3D电影版：追寻草帽	海贼王3D:草帽追逐战	航海王3D：追逐草帽大冒险
地下理想国	地下理想国
暴力监狱第二季	超级监狱	暴力监狱
花田少年史	HanadaShonen-Shi	TheHistoryofHanadaIchiro
小喇叭绘本动画
动画城
呼风唤雨光荣的烤肉之路	CrayonShin-chan:ArashiwoYobuEikounoYakinikuRoad	呼风唤雨光荣的烤肉之路
51号星球	外星51	第51号星球
蝙蝠侠大战罗宾	蝙蝠侠与罗宾	蝙蝠侠VS罗宾
灰与幻想的格林姆迦尔	HaitoGensounoGrimgar
爱丽丝梦游仙境2：镜中奇遇记	爱丽丝镜中奇遇记	AliceinWonderland:ThroughtheLookingGlass
鬼马小精灵	卡斯珀	鬼马小灵精
星河战队：入侵	スターシップ・トゥルーパーズインベイジョン
小雪人大行动	装饰瓶
空之境界第六章忘却录音	空之境界电影版6：忘却录音	Chapter6TheGardenofSinners-fairytale
南方公园第十六季	衰仔乐园第十六季	南方四贱客第十六季
爱宠大机密2	PetPet当家2	宠物当家2
源氏物语	TheTaleofGenji	GenjiMonogatari
伤物语2：热血篇	KizumonogatariPart2:Nekketsu-hen
晴天小猪	晴天PIGPIG	TokyoPig
加菲猫和他的朋友们第一季	加菲猫	加菲猫和他的朋友
千子	Cencoroll	Senkorôru
小叮当：永无兽传奇	Clochetteetlacréaturelégendaire
龙珠Z：复活的F	七龙珠Z：复活的F	DoragonbôruZ:Fukkatsuno'F'
黑塔利亚第4季	废柴意大利第4期
Free	水泳部	男子水泳部
正义联盟：亚特兰蒂斯的宝座	正义联盟：亚特兰蒂斯王座
秦时明月之一舞倾城	诸子百家新年特别版
圣斗士星矢：极乐净土篇	圣斗士星矢冥王哈迪斯篇：极乐净土	圣斗士星矢极乐净土篇
新世纪福音战士2003重制版	DVD重制版
四月一日灵异事件簿2	四月一日灵异记事簿2	次元魔女2
混凝土革命超人幻想第二季	ConcreteRevolutio超人幻想第二季
百无禁忌女高中生私房话	告诉我小辣妹	告诉我辣妹子酱
大眼仔的新车	麦可的新车	怪兽电力公司番外篇
海绵宝宝第二季
南家三姊妹～再来一碗～	南家三姐妹第二季	南家三姐妹第2季
交响诗篇	KoukyoushiHen:EurekaSeven
四驱小子	四驅小子	四驱郎
辛普森一家第二十七季
蜡笔小新之呼风唤雨夕阳下的春日部男孩	CrayonShin-chan:arashiwoyobu	CrayonShin-chan:TheKasukabeBoysoftheEveningSun
剑风传奇黄金时代篇2：多尔多雷攻略	剑风传奇剧场版	Berserk:Ohgonjidaihen2-dorudoreikoryakuhen
成年女性的动画时间：滑过河面的风
天元突破红莲螺岩	天元突破红莲之眼	天元突破グッレンラガン
蝴蝶梦：梁山伯与祝英台	TheButterflyLovers：LeonandJo
马达加斯加企鹅第一季	马达加斯加企鹅第一季
芭比之真假公主	芭比之真假公主
拖线与鬼火	脱线与鬼火	拖线与鬼火
上课小动作	邻座的关君	邻座同学是怪咖
守望者：黑船传奇	Watchmen:TalesoftheBlackFreighterandUndertheHood	黑货船传奇
新世纪福音战士剧场版：死与新生	NeonGenesisEvangelion:Death&Rebirth	ShinseikiEvangelionGekijô-ban:Shitoshinsei
红白黑黄第二季
他和她的事情	他与她的事情	彼氏彼女的故事
全金属狂潮3	FullMetalPanicTheSecondRaid	全金属狂潮3二度冲击
瑶玲啊瑶玲	요랑아요랑아（韩国）	魔法小迷狐（台）
空之境界未来福音	空之境界剧场版：未来福音	FutureGospel
灰羽联盟	Haibanerenmei
星球大战：克隆战争	星际大战：复制人之战	星球大战：复制战纪
喜羊羊与灰太狼之牛气冲天	喜羊羊与灰太狼1	PleasantGoatAndBigBigWolf
福是全家福的福第一季
钢之炼金术师：盲目的炼金术师	钢之炼金术师SP1-盲目的炼金术师
武庚纪	封神纪
小鲤鱼跳龙门
渔童
野良神OAD4	河屯君乐园	APictureTogether
绿灯侠：首次飞行	绿灯侠：首次飞行
棒球英豪	邻家女孩	棒球小子
鸟之诗	青空下的传说
黑暗光明黑暗	DarknessLightDarkness	黑暗光明黑暗
王牌投手振臂高挥夏季大会篇	王牌投手振臂高挥第二季
大耳朵图图
血型君	ABO	血型君的故事
空之境界未来福音extrachorus	FutureGospelextrachorus	TheGardenofSinners:RecalledOutSummerextrachorus
森林王子	小泰山	丛林之书
少年故事	少年故事	黑客帝国动画版
草莓棉花糖	Ichigomashimaro	草莓棉花糖
乡村医生	卡夫卡乡村医生	ACountryDoctor
食灵：零	食灵前传	Ga-rei:Zero
鲁邦三世：卡里奥斯特罗城	鲁邦三世：古城之谜	LupinIII:CastleofCagliostro
夏娃的时间	夏娃的时间剧场版	Evenojikan
钟楼怪人	钟楼怪人	钟楼驼侠
宠物小精灵：洛奇亚爆诞	神奇宝贝：洛奇亚爆诞
Q弟侦探因幡	角質層偵探因幡
足球小将J	足球小将（世青篇）	CaptainTsubasaJ
死神训练班	Deathigner	DeathSchool
机动战士高达THEORIGINI青瞳的卡斯巴尔	机动战士敢达THEORIGINI青瞳的卡斯巴尔
迎新日	卑鄙的我番外篇：迎新日	新生辅导日
巴巴爸爸第一季	可里可里可里，巴巴变
正义联盟：神魔之战	正义联盟：神明与怪物	正义联盟：神魔世界
瑞奇与叮当	拉捷特与克拉克	Ratchet&Clank
中二病也要谈恋爱恋	中二病也要谈恋爱第二季	中二病也要恋爱恋
蜡笔小新：超级美味B级美食大逃亡	蜡笔小新2013：超级美味B级美食大逃亡
头文字D第一季	InitialD:FirstStage
樱桃小丸子2	樱桃小丸子动画版	ChibiMaruko-chan
超时空要塞DELTA	MACROSSDELTA	超时空要塞△
西岳奇童
寒蝉鸣泣之时·解	寒蝉鸣泣之时·解	暮蝉悲鸣时·解
欢迎加入NHK	NHKniyôkoso	WelcometoN.H.K
我是哪吒
剧场版魔法少女小圆前篇起始的故事	PuellaMagiMadokaMagicatheMovie:Beginnings
全部成为F
此时此刻的我	nowandthen,hereandthere	超时空幻境
啦啦啦德玛西亚第一季	LalalaDemacia
南方公园第十三季	南方四贱客第十三季	衰仔乐园第十三季
小叮当	TheTinkerBellMovie	TinkerBellandtheRingofBelief
秦时明月特别篇之罗生堂下	秦时明月之罗生堂下
我们大家的河合庄	BokurawaMinnaKawaisou
为美好的世界献上祝福	祝福这个美好的世界
海底小精灵	海底小精灵
甘达星人	甘达星人
纳米核心第二季	纳米核心抉择篇
哆啦A梦：大雄与银河超特急	Doraemon:NobitatoGingaekusupuresu
哆啦A梦：大雄的猫狗时空传	Doraemon:NobitanoWanNyanJikûden
圣斗士星矢冥王哈迪斯冥界篇前章	SaintSeiya:TheHadesChapter-Inferno	圣斗士星矢:冥界篇
拽妹黛薇儿第五季
欢乐树的朋友们：第一滴血	快乐森林1：第一滴血	快乐森林短片合集
芭比梦幻仙境之人鱼公主	芭比梦幻仙境之人鱼公主
小胖妞	TheBigGirl
五岁庵	五岁的心愿	Oseam
声之形
邻座的怪同学OAD：邻座的极道同学	となりの怪物くんOAD	TonarinoGokudō-kun
尸体派对OVA：被暴虐的灵魂的咒叫	尸体派对TorturedSouls
功夫兔与菜包狗	功夫兔与菜包狗
囧男窘事第一季	蒂姆的糟糕生活第一季	囧男二三事第一季
虹色萤火虫，永远的暑假	彩虹萤火虫：永远的暑假	虹色萤火虫～永远的暑假～
帽子梦魇	TheHat	帽子梦魇
阿祖尔和阿斯马尔	一千零二夜	阿叙尔和阿思玛尔
无头骑士异闻录第二季：承	无头骑士异闻录×2
南方公园第三季	衰仔乐园第三季	南方四贱客第三季
名侦探柯南特典：怪盗基德诞生的秘密	名侦探柯南M14特典：怪盗基德诞生的秘密	名侦探柯南SP：怪盗基德诞生
南方公园第九季	衰仔乐园第九季	南方四贱客第九季
彼得的龙	寻龙传说	妙妙龙
吉诺密欧与朱丽叶	糯米欧与朱丽叶	糯米欧与茱丽叶
世界第一初恋：横泽隆史的场合
高桥留美子梦幻剧场犬夜叉特别篇黑色铁碎牙	It'saRumicWorldInuyasha-"BlackTetsusaiga"	高桥留美子梦幻剧场犬夜叉特别
傻瓜与天使	我很狗，但我是天使	白痴和天使
历物语
机器的复兴：第1部	机器的复兴：第1部	黑客帝国动画版
降世神通：科拉传奇第一季	TheLastAirbender:TheLegendofKorra
机器的复兴：第2部	机器的复兴：第2部	黑客帝国动画版
动画师生存手册	AManualofMethods,Principles,andFormulasforClassical,Computer,Games,StopMotion,andI
变形金刚大电影	变形金刚：大电影
听爸爸的话	听爸爸的话
玉子市场	TamakoMarket
沃特希普高地	沃特希普荒原	海底沉舟
神奇宝贝剧场版：波尔凯尼恩与机巧的玛吉安娜
食戟之灵OVA2暑假的绘里奈
使徒行者	使徒行者电影版	LineWalker
爱丽丝梦游仙境	爱丽丝漫游仙境	魔境梦游
摔跤的罗密欧与朱丽叶	假面舞踏会	Kick-Heart覆面舞踏会
香蕉喵
噬魂师	SoulEater	噬魂者
白雪公主和三只小猪	SnowWhiteandtheThreePigs
幸运星	幸运星	らきすた
图书馆战争：革命之翼	图书馆战争剧场版
花与树	花与树
双月之城	龙吟沧海
时光钟摆
赤发的白雪姬	红发的白雪公主	SnowWhitewiththeRedHair
乐高DC超级英雄：正义联盟大战异魔联盟	乐高超级英雄：正义联盟对比扎罗联盟
猫怪麦克	小林家的猫	俏皮猫麦克
小虎还乡	小虎历险记
伏：铁炮娘的捕物帐	伏铁炮娘的捕物帐	FuseTeppoMusumeNoTorimonocho
蒙娜丽莎步下楼梯	MonaLisadesciendeunaescalera
扯线王子复仇记	木偶迷城	扯线王子复仇记
对学生会长的忠告OVA1	学生会长请小心
布拉德·尼利神经秀第一季
最终流放	最终流放
睡美人	Isabelleauboisdormant
少年阴阳师	Shônenonmyôji
海贼王特别篇：迷雾岛大冒险	OnePieceSpecial:AdventureofNebulandia
探险活宝第六季
小羊肖恩第一季	超级无敌羊咩咩	笑笑羊
小美人鱼3：爱丽儿的起源	小美人鱼：回到当初	小美人鱼3：爱丽儿的起源
城镇青年	タウンワーカース
超人总动员2	超人特攻队2	超人家族2
爱丽丝	艾丽丝	Alice
小熊维尼历险记	小熊维尼历险记
2112年哆啦A梦诞生	2112年哆啦A梦诞生
想起了你	永失我爱	想你时你在天边
小熊维尼
珂赛特的肖像	珂赛特的肖像	Cossettenoshôzô
南方公园第十四季	衰仔乐园第十四季	南方四贱客第十四季
三眼神童	三目童子	三眼小子
飞出个未来第四季
吉祥宝宝之我是食神
散华礼弥	Sankarea	僵尸哪有那么萌
超时空大冒险
无嘴人
海绵宝宝第三季
勇敢的兔八哥
终极细胞战	捍胃战士	终极细胞战
懒蛋蛋	Gudetama
钢之炼金术师：单纯的人们	SimplePeople	钢之炼金术师SP2-单纯的人们
辛普森一家第十四季	阿森一家第十四季
命运之夜剧场版	命运长夜剧场版	命运守护夜剧场版
章鱼的爱情	章鱼情侣	两只章鱼的爱情
游戏人生	NoGameNoLife
哆啦A梦：大雄与绿巨人传	哆啦A梦08剧场版：大雄与绿巨人传	Doraemon:NobitaandtheGreenGiantLegend
请安静	请保持安静	请安静
守护甜心	守护甜心
神兽金刚之青龙再现	神兽金刚大电影	GodbeastMegazord:ReturnofGreenDragon
南家三姐妹	Minamike	Minami-ke
野良神OAD3	TheYatogamiSerialMurderIncident:NoragamiSuspenseTheatre
卫星女孩和奶牛	卫星少女与花牛	TheSatelliteGirlAndMilkCow
暴力监狱第三季	超级监狱
永久家族	EternalFamily	Eikyuukazoku
出包王女	茶煲情缘
少女杀手	カイトリベレイター	少女杀手
京骚戏画	Kyousougiga
成龙历险记第二季
拽妹黛薇儿第四季
爱丽丝学园	GakuenAlice	GardenAlice
黑礁第二季	BlackLagoon
恶魔高校D×DBorN	HighSchoolD×D第3季
迪普的未解之谜指南第一季	怪诞小镇迷你剧第一季
蜡笔小新呼风唤雨黄金的间谍大作战	蜡笔小新呼风唤雨黄金的间谍大作战
游戏王第一部	游戏王	游戏王前传
天下霸道之剑	天下霸道之剑
飞哥与小佛第一季	飞哥与小佛
机动战士高达：铁血的奥尔芬斯	机动战士高达：铁血孤儿	機動戦士ガンダムGの鉄血
黑岩射手	TVANIMATIONBLACK☆ROCKSHOOTER
飞出个未来第五季
火影忍者疾风传剧场版：火之意志的继承者	火影忍者疾风传剧场版继承火之意志之人	火之意志的继承者
越狱兔第四季	普京兔和基里连科兔	Usavich
秀逗魔导士	スレイヤーズ
最游记外传OVA第一卷：樱云之章
最游记外传OVA第三卷：萌芽之章
彩云国物语	TheStoryofSaiunkoku	SaiunkokuMonogatari
灌篮高手剧场版2	SLAMDUNK全国制覇だ桜木花道
圣诞颂歌	奇幻圣诞颂	圣诞夜怪谭
黑塔利亚第6季
当女孩遇到熊	熊巫女
哆啦A梦：新·大雄与铁人兵团	新·大雄与铁人兵团	电影多啦A梦-新·大雄与铁人兵团
LoveLive剧场版	LoveLive学园偶像	ラブライブTheSchoolIdolMovie
熊的传说	熊兄弟	熊之历险
马可波罗回香都	马可波罗回香都
皇家国教骑士团	地狱之歌	王立国教骑士团
快乐东西	HappyStuff
肉之恋	肉之恋
学园handsome
阿斯特里克斯历险记：诸神之宫殿	高卢英雄历险记:诸神之神殿	Asterix：TheMansionsoftheGods
周日午餐	SundayLunch
最游记外传OVA特別篇：香花之章
鹬蚌相争	Snipe-ClamGrapple
六花的勇者	六花之勇者	RokkanoYuusha
凭物语	Tsukimonogatari
攻壳机动队SAC：笑面男	攻壳机动队之笑面男	攻壳机动队OVA之笑面男
崂山道士
东郭先生	ElSeñorTunKuo
水星领航员第2季	水星领行员第二季	水星领行员
花吻在上OVA~恋人的羁绊～	亲吻那片花瓣OVA~恋人的羁绊～
甜甜私房猫	甜甜私房猫
超级英雄之死	爱情超能量
无头骑士异闻录第二季：转OVA	无头骑士异闻录×2转恋爱故事铿铿铿
漩涡鸣人成为火影的日子	火影忍者剧场版博人传光盘特典：漩涡鸣人成为火影的日子
女神异闻录3剧场版第三章秋降	ペルソナ3THEMOVIE#3FallingDown
Rewriteリライト
元首的真面目	元首的面孔
魔法禁书目录2	魔法禁书目录第二季	魔法禁书目录II
缘之空	缘分的天空	ヨスガノソラ
Free第二季	水泳部第二季
鲸的鱼跃	鲸的鱼跃	KujiranoChôyaku
在地下城寻求邂逅是否搞错了什么	期待在地下城邂逅有错吗
头文字D第二季	头文字D：SecondStage	InitialD:SecondStage
勿忘蛛	Wasurenagumo
美少女战士R	美少女战士第二季	PrettySoldierSailorMoonR
猫眼三姐妹	キャッツ♥アイ	Cat'sEye
叽哩咕历险记	叽里咕与女巫	女巫与叽里咕
头文字D新剧场版：闘走	NewInitialDtheMovieLegend2:Racer
璐璐狼：惊奇大秘密	卢卢狼：惊奇大秘密	Wolfy,theIncredibleSecret
贝奥武夫	魔战王：贝奥武夫	贝奥武夫:北海的诅咒
黑塔利亚第5季	百无一用意呆利第5季	ヘタリアAxisPowers5期
大叔与棉花糖	棉花糖大叔
正义联盟第二季	正义联盟
超人大战极英盟	超人大战极英盟
蜡笔小新之森林里的暴风雨	蜡笔小新森林里的暴风雨
好奇的乔治	好奇猴乔治	好奇的乔治
梅与小猫巴士
亚瑟和他的迷你王国2	亚瑟的奇幻王国：马塔杀的复仇	亚瑟与马塔札德的复仇
秋日天空～在梦中～	秋色之空～在梦中～	秋日天空～在梦中～
名侦探柯南OVA11：来自伦敦的秘密指令	名侦探柯南OVA11来自伦敦的秘密指令
机动警察剧场版2	机动警察2：和平保卫战	机动警察电影版2：和平保卫战
读或死	ReadorDie	读或死
灌篮高手剧场版3	SLAMDUNK湘北最大の危機燃えろ桜木花道
蜂蜜与四叶草L特别篇	Honey&CloverSpecialChapterL
进化简史	纸张上的进化史
超级无敌掌门狗：引鹅入室	酷狗宝贝2：引鹅入室	超级无敌掌门狗：着错裤
希腊悲剧	AGreekTragedy
悠哉日常大王第二季	のんのんびより2期	悠哉日常大王Repeat
酵母与鸡蛋公主	面包种子与鸡蛋公主	Pan-danetoTamago-hime
极地大冒险2	尼科的圣诞历险2	尼科救亲记
铁扇公主	PrincessIronFan
银河铁道999	GingatetsudôThree-Nine	GalaxyExpress999
鼠国流浪记	鼠国漂流记	酷鼠大冒险
绝园的暴风雨	绝园的暴风雨
火星异种：复仇	テラフォーマーズ2期	TerraFormarsRevenge
惊爆游戏
小叮当：拯救精灵大作战	小叮当：夏日风暴	奇妙仙子：拯救精灵大作战
黑暗扫描仪	盲区行者	双面魔神
钢之炼金术师：师傅的故事	師匠初恋物語	主妇18岁的日子
荒川爆笑团第二季	荒川爆笑团第二部
莫克和甜甜	甜甜历险记	小地鼠阿曚
笨蛋·测验·召唤兽	笨蛋，测试，召唤兽
玻璃假面	千面女郎	GlassMask
野良神OAD2	APromiseinSpring
猫和老鼠：胡桃夹子的传奇	猫和老鼠：胡桃夹子的传奇	猫和老鼠胡桃夹子传奇
恶魔高校D×D	HighSchoolD×D	高校龙中龙
乱步奇谭：拉普拉斯的游戏
弹珠警察	BomBom弹珠人	弹珠超人
花园宝宝	夜晚园
熊猫的故事	TheStoryofPandaTaotao
南方公园第六季	衰仔乐园第六季	南方四贱客第六季
乌鸦之日	乌鸦的日子	DayoftheCrows
Q版猫和老鼠	小猫和小鼠	Q版猫和老鼠
游戏王怪兽之决斗	游戏王DM	Yû-gi-ôh:DuelMonsters
吹响悠风号TV未放送回	吹响上低音号TV未放送回
火影忍者剧场版：血狱	火影忍者剧场版：血狱	GekijoubanNaruto:Buraddopurizun
年老的鳄鱼	TheOldCrocodile	Toshiwotottawani
狼少女与黑王子OAD
野良神OAD1	God'sPossession,God'sCurse
少女与战车OVA：这次是真正的安齐奥战	少女与战车OVA
老磨坊	老磨坊
冰雪奇缘2
邋遢大王奇遇记	邋遢大王奇遇记影院版	SlovenlyBoy'sAdventure
OZ国历险记	TheWonderfulWizardofOz	绿野仙踪
飞出个未来第七季	飞出个未来
魔界都市新宿	DemonCityShinjuku
三国志：英雄的黎明	三国志:英雄的黎明
成龙历险记第五季
风中奇缘2	风中奇缘II
哆啦A梦：大雄的大魔境	Doraemon:NobitaandtheHauntsofEvil
哆啦A梦：大雄的海底鬼岩城	Doraemon:NobitanoKaiteikiganjô
哆啦A梦：大雄与铁人兵团	哆啦A夢：大雄与铁人兵团	哆啦A梦：大雄与铁人兵团
哆啦A梦：大雄的阿拉伯之夜	大雄的天方夜谭	Doraemon:NobitanoArabiannaito
哆啦A梦：大雄与白金迷宫	Doraemon:NobitatoBurikinorabirinsu
哆啦A梦：大雄的南海大冒险	Doraemon:Nobita'sSouthSeaAdventure	Doraemon:Nobitanonankaidaibôken
哆啦A梦：大雄的宇宙漂流记	Doraemon:Adventure:DriftsintheUniverse	Doraemon:NobitanoUchûhyôryûki
无限斯特拉托斯	InfiniteStratos
红色的梦	独轮车的梦想	小红车的梦
机动战士高达THEORIGINIII破晓的起义	机动战士高达THEORIGINIII破晓的起义	MobileSuitGundam:TheOriginIII:Dawnof
乌龟和兔子	龟兔赛跑
海贼王剧场版7：机关城的机械巨兵	海贼王电影版2006：机关城的钢铁巨兵	Onepiece:KarakurishironoMechaKyohei
猫和老鼠喜剧秀	TheTomandJerryComedyShow
攻壳机动队SAC2ndGIG：个别的十一人	Kôkakukidôtai:S.A.C.2ndGIG-Individualeleven	GhostintheShell:S.A.C.2ndGIG-Indi
壳中少女：排气	MardockScrambleTheThirdExhaust
仙履奇缘3：时间魔法	仙履奇缘3：魔法时刻	灰姑娘3：魔法时刻
守望先锋：双龙
降世神通：科拉传奇第四季	TheLegendofKorra:BookFour:Balance
捉妖记	聊斋之宅妖	聊斋之捉妖记
矩阵化	矩阵化	黑客帝国动画版
银魂：白夜叉降诞预告	银魂OVA
丹特丽安的书架	丹特丽安的书架
勇利onICE	YurionIce
零之使魔	Zeronotsukaima	零之使魔
七鬼神	神幻拍档	七鬼神
小羊肖恩第四季	超级无敌羊咩咩第四季	笑笑羊第四季
生化猎人	BioHunter
雕塑大卫的出逃	大卫的小卫
交响情人梦终曲	如歌的野田废	交响情人梦Finale
迷糊餐厅	ワーキング
我叫MT第一季	I'mMT
疯狂原始人2
驯龙记：伯克岛的龙骑手第一季	驯龙记：博克岛的骑手
丛林之王	人猿泰山
虚拟程序	虚拟程序	黑客帝国动画版
变种外星人	Lesmutantsdel'espac
最近1
蜡笔小新之动感超人大战泳装魔王	蜡笔小新之动感超人大战泳装魔王
小魔女蒙娜第一季	小魔女蒙娜
境界的彼方剧场版未来篇	BeyondtheBoundarytheMovieI'llBeHere:TheFuture	GekijoubanKyokainoKanataI'llBeHer
名侦探柯南：逃亡者·毛利小五郎	名侦探柯南M18特典
抓鬼天狗帮	捉鬼天狗帮
龙珠Z：神与神	DragonBallZ:BattleofGods
王牌投手振臂高挥	王牌投手	振臂高挥
壳中少女：燃烧	MardockScrambleTheSecondCombustion
蝙蝠侠超人大电影-最佳搭档	蝙蝠侠超人大电影-世界警察
剧场版神奇宝贝BestWishes酋雷姆VS圣剑士凯尔迪奥	PocketMonstersBestWishesTheMovie:Kyuremvs.theSacredSwordsman:Keldeo	劇場版ポ
入学考试	太极鼠之入学考试	EntranceExam
junkhead1
最游记RELOAD	最游记第二部	SaiyukiReload
宇宙骑士	KnightTekkamanBlade	StarknightTekkamanBlade
虫师铃之滴	虫师特别篇铃雨	虫师续章特别篇铃雨
史努比的故事
火影忍者疾风传剧场版：羁绊	火影忍者疾风传剧场版羁绊	火影忍者疾风传剧场版：绊
老鼠的麻烦	老鼠的麻烦
可可可心一家人	可可可心一家人1
交响情人梦巴黎篇	NodameCantabileParis
钢之炼金术师：那也是他的战场	钢之炼金术师SP4	YetAnotherMan’sBattlefield
小神仙和小仙女
泡芙小姐第一季	MissPuff
数码宝贝3：驯兽师之王	数码暴龙3：驯兽师之王	数码兽驯兽师
功夫熊猫之师傅的秘密	功夫熊猫之师傅的秘密
皮克斯工作室：25个神奇时刻
小桃小栗LoveLove物语
世界第一初恋：小野寺律的场合	世界一初恋OAD
糖果男孩EX	糖果男孩
猫狗大战	猫狗斗一番	猫狗大战
恋爱随意链接	心连‧情结	心灵链环
翼·年代记	TsubasaChronicle	翼・年代记
宇宙小子第一季	宇宙仔斯蒂文	神脐小卷毛
迷雾中的小刺猬	LittleHedgehogintheFog	Yozhikvtumane
偷窥的小洞OVA	偷窥的小洞OVA	孔中窥见真理之貌OVA
月亮街
奇异博士
一周的朋友	OneWeekFriends
半夜鸡叫	LeCoqchanteàminuit
不射之射	ToShootWithoutShooting
小蜜蜂寻亲记	昆虫物语孤儿小哈奇	小蜜蜂寻母记
恶作剧之吻	淘气小亲亲	一吻定情
雷欧奥特曼	雷欧·奥特曼	UltramanReo
信长协奏曲	NobunagaConcerto
七大罪圣战的预兆	七大罪特别篇
银魂：无论什么事开始虽然重要但伸个懒腰的话也不错
数码宝贝大冒险tri.第1章：再会	デジモンアドベンチャー世界中の“選ばれし子どもたち”へ	DigimonAdv
蝙蝠侠：动画版第一季	Batman:TheAnimatedSeries
飞天少女猪	とんでぶ～りん	飞天少女猪
安德鲁和威利冒险记	安德烈与威利的冒险
无限的未知	无限的利维亚斯	MugennoRyvius
忍者乱太郎	にんたまらんたろう	NintamaRantaro
全明星超人	全明星超人
海绵宝宝第七季
灌篮高手剧场版1	SLAMDUNK
影鳄	Kagewani
最游记外传OVA第二卷：散华之章	最游记外传
人类衰退以后	人类衰退之后
战斗妖精雪风	战斗妖精雪风
死后文	Shigofumi	死后文
宠物小精灵：神速的灭世虫-超梦觉醒	神速的盖诺赛克特超梦觉醒	精灵宝可梦神速的盖诺赛克特超梦觉醒
喜羊羊与灰太狼之兔年顶呱呱	喜羊羊与灰太狼3	MoonCastle:TheSpaceAdventure
GAMBO
间之楔	AiNoKusabi	间之楔
花开伊吕波剧场版：甜蜜的家	HanasakuIrohaHomeSweetHome
我是小甜甜	魔法天使	MahônotenshiCreamyMami
三国演义	最強武将伝三国演義	三國演義
飞出个未来大电影3：班德的游戏	未来世界：本德的游戏	TheFuturamaMovie3
大陆之所以漂移：第二部分	小松鼠之大陆分裂2	大陆漂移的原因2
名侦探柯南OVA1：宝刀争夺大作战	名侦探柯南OVA1：柯南VS基德VS铁剑宝刀争夺大决战
吸血鬼骑士：罪
狗与剪刀的正确用法	狗与剪刀必有用	铰剪狗
白雪公主之魔镜魔镜	魔镜﹡魔镜：白雪公主决战黑心皇后	白雪公主
你的老鼠朋友	你的朋友，老鼠	你的老鼠朋友
超越极限	超越极限	黑客帝国动画版
名侦探柯南OVA4：柯南、基德和水晶之母	Conan,KidandtheCrystalMother	名侦探柯南OVA4-柯南、基德和水晶之母
JoJo的奇妙冒险	JoJo的奇妙冒险OVA第一期	JoJo'sBizarreAdventure
火影忍者剧场版：大兴奋三日月岛的动物骚动	NarutotheMovie3:TheAnimalRiotofCrescentMoonIsland	NarutotheMovie3:Guardiansoft
八犬传：东方八犬异闻	南总里见八犬传
苹果核战记2	苹果核战记剧场版续集	AppleseedSaga:ExMachina
扬基都德鼠	扬基都德鼠
天鹅湖	世界名作童话：天鹅湖	SwanLake
海绵宝宝第四季
犹太长老的灵猫	拉比的猫	TheRabbi'sCat
啦啦啦德玛西亚第二季
无彩限的怪灵世界
悠久之翼	悠久之翼
音响生命体	音响生命体Noiseman	OnkyoseimeitaiNoiseman
探索者的目标
杀戮都市	杀戮都市
空之境界	空之境界TV版
超智游戏	ONEOUTS~nobodywinsbutI
舰队收藏	KantaiCollection:KanColle	舰队收藏
山林小猎人	森林小猎人
芭比之天鹅湖
日常工作第三季	天兵公园	日常参考
加速世界OVA#EX02Vacation；温泉	AccelWorldOVA#EX02Vacation	アクセル・ワールド-加速の頂点-
小马快跑	米奇拯救米妮大作战	马儿快跑
疯狂动物城2
降世神通第一季	Avatar-TheLastAirbender	降世神通
飞出个未来大电影2：万背之兽	飞出个未来：电影版2	TheFuturamaMovie2
人生BestTen	成年女性的动画时间：人生BestTen
铁胆火车侠2	LightningAttackExpress
种树的牧羊人	TheManWhoPlantedTrees	种树人
高达创战者Try岛上战争	高达创战者OVA	高达创战者TryIslandWars
辛巴达七海传奇	仙巴之七海游踪	辛巴达航海
美男高校地球防卫部LOVELOVE
阿凡提的故事之吝啬鬼	第六集：吝啬鬼
暗杀教室：毕业篇	暗杀教室：真人版·续篇	暗杀教室：卒业篇
世界第一初恋：情人节篇
海绵宝宝第六季
辛普森一家第十五季
蜡笔小新呼唤传说三分钟嘎巴大进攻
女娲补天
天空战记	TenkûsenkiShurato
间谍亚契
哆啦A梦：大雄的新魔界大冒险之7个魔法师	哆啦A梦07剧场版：大雄的新魔界大冒险之7个魔法师	多啦A梦大雄的新魔
召唤恶魔阿萨谢尔第二季	恶魔阿萨谢尔在召唤你第二季	召唤恶魔2
更大的图画	更大的图像
超神学院第2季	啦啦啦德玛西亚第5季
灌篮高手剧场版4	SLAMDUNK吠えろバスケットマン魂花道と流川の熱き夏
哥特萝莉侦探事件簿	哥特侦探	哥特式萝莉侦探事件簿
春之觉醒	MyLove	Moyalyubov
名侦探柯南特典：新一与小兰·麻将牌与七夕的回忆	名侦探柯南剧场版第13弹特典	新一与小兰·麻将牌与七夕的回忆
海格力斯	赫拉克勒斯
道子与哈金	MichikoToHatchin	道子与哈金
机动战士高达THEORIGINII悲伤的阿尔黛西亚	机动战士高达起源2	MobileSuitGundam:TheOriginII:Artesia'sSorrow
蜡笔小新之云黑斋的野心	云黑斋的野心	CrayonShinChanMovie3
南方公园第十二季	衰仔乐园第十二季	南方四贱客第十二季
辛普森一家第二十四季	阿森一族第二十四季
沃土第二季
可爱的Muco	家有穆珂
死神剧场版BLEACH地狱篇	剧场版BLEACH地狱篇
双星之阴阳师
恐怖玩具屋	邪恶娃娃屋
数码宝贝大冒险tri.第2章：决意	DejimonAdobenchâtri2:Ketsui
幸存的生命（理论与实践）	SurvivingLife	梦中见
乐高大电影：蝙蝠侠	乐高蝙蝠侠大电影	Lego蝙蝠侠英雄传
星际宝贝2：史迪奇	星际宝贝2:史迪奇	星际宝贝2:史迪奇有问题
两个火枪鼠	两个火枪鼠
钢之炼金术师：叹息之丘的圣星	钢之炼金术师：米洛斯的圣星	钢之炼金术师：叹息之丘的神圣之星
蜡笔小新：风起云涌我的宇宙公主	蜡笔小新：风起云涌我的宇宙公主
城市猎人	CityHunter
三只小猫
青蛙总动员
从前有座灵剑山	灵剑山群星之宴
网球王子全国大赛篇	网球王子全国大会篇	网球王子OVA：全国大赛篇
刀语	Katanagatari
灼眼的夏娜	ShakugannoShana
神秘世界历险记	奇异家族	Yugo&Lala
凉宫春日的忧郁2009	凉宫春日的忧郁1X2	凉宫春日的忧郁2
穿越时空的思念	穿越时空的思念	時代を越える想い
镜中的梦幻城	镜中的梦幻城
红莲之蓬莱岛	红莲之蓬莱岛
濑户的花嫁	濑户的新娘	SetonoHanayome
校园迷糊大王一学期	SchoolRumble	喧嚣学园
世界第一初恋：羽鸟芳雪的场合	羽鸟芳雪的场合
电器街的漫画店	DenkigainoHonya-san	ElectricDistrict'sBookStore
四月一日灵异事件簿·笼：徒梦	四月一日灵异记事簿·笼：徒梦
斗牌传说	Akagi	斗牌传说
守望先锋：英雄
绿野仙踪	OZ国历险记	WizardofOz
青蛙的预言	哗啦哗啦漂流记	大雨大雨一直下
JoJo的奇妙冒险	Jojo'sBizarreAdventure
人参娃娃	GinsengBaby
梦与狂想的王国	TheKingdomofDreamsandMadness
小叮当与海盗仙子	TinkerBellandtheQuestfortheQueen
彼德与狼	彼得与狼	PeterandtheWolf
拽妹黛薇儿之暑假要结束了没	IsItFallYet	Daria:IsItFallYet
宇宙兄弟	UchūKyōdai
海月姬：水母公主	Kuragehime
彭彭丁满历险记第一季	TimonandPumbaa	彭彭丁满漫游世界
守望先锋：最后的堡垒
女神异闻录3剧场版第一章春生	Persona3theMovie#1SpringofBirth
狼与香辛料2	狼与香辛料第二季
足球小将GOAL	CaptainTsubasa:RoadtoDream	CaptainTsubasa:Roadto2002
鬼灯的冷彻OAD3	HoozukinoReitetsuOAD3	Hozuki'sCoolheadednessOAD3
完美小姐进化论	完美小姐进化论
喜羊羊与灰太狼之虎虎生威	喜羊羊与灰太狼2之虎胆羊威	喜羊羊与灰太狼2：虎虎生威
倒霉熊第一季	贝肯熊	倒霉熊
阿甘妙世界第一季	阿甘妙世界	卡姆鲍尔的奇妙世界
借一只爪	借一只爪
啦啦啦德玛西亚第三季
搞笑漫画日和4	ギャグマンガ日和4	增田幸助剧场搞笑漫画日和＋
冰雪女王	Snezhnayakoroleva	TheSnowQueen
调酒师	Bartender
机动战士高达Seed	機動戦士ガンダムSEED	MobileSuitGundamSeed
大风车	BigPinwheel
守望先锋：新生
暴力监狱第四季	超级监狱
我爱你	ジュテーム
道格的特别任务
海贼王15周年纪念特别篇——幻之篇章「3D2Y跨越艾斯之死与路飞伙伴的誓言」
我家浴室的状况	我家浴缸的二三事	我家浴室的现况
ASIENCE～头发是女人的生命	ASIENCE～头发是女人的生命
ONYOURMARKGhibli实验剧场	ONYOURMARK
攻壳机动队：崛起2	GhostintheShellArise:Border2-GhostWhisper
潜艇三明治
海公子
高中舰队	はいふり	HIGHSCHOOLFLEET
派对恐龙	恐龙雷克斯	抱抱龙大英雄
辛普森一家第六季	辛普森一家
亚瑟·圣诞	亚瑟少爷救圣诞	圣诞快递
恐怖宠物店	恐怖宠物店	ペットショップ・オブ・ホラーズ
飙速宅男第一季	弱虫脚踏板
绿灯侠：翡翠骑士	绿灯侠：绿色骑士
阿茹茉妮	Harmonie
正义联盟：时间困境
阿凡提的故事之宝驴	第十一集：宝驴
阿凡提的故事之真假阿凡提	第十三集：真假阿凡提
骄傲的将军
记录的地平线	LogHorizon
择天记第一季
海绵宝宝第五季
俗世乐土第二季	丑陋的美国人
头文字D第三舞台	头文字D：ThirdStage	頭文字D：ThirdStage
头文字D第四季	InitialD:ProjectD	头文字D：FourthStage
战勇2
魔境仙踪	奥兹大帝	奥兹巫师
神奇海盗团	海贼天团3D	海盗王之超级无敌大作战
蜡笔小新：爆睡在梦的世界大突击	蜡笔小新剧场版24	蜡笔小新2016年剧场版
羊羊小侦探
丛林大反攻4：吓傻了	打猎季节4	丛林大反攻：狼人来了
辛普森一家第三季	阿森一家第三季
夏威夷假期	玩具总动员之夏威夷假期	ToyStoryToons
丛林大反攻3	狩猎季节3	打猎季节3
美少女战士SailorStars	美少女战士之最后的星光	SailorMoonSailorStars
命运石之门：聪明睿智的认知计算
超级肥皂	SuperSoap
女巫的扫帚	扫帚上的家	女巫扫帚排排坐
毕加索与公牛	PicassoandHisBull
夜明前的琉璃色	夜明前的琉璃色
那就是声优
耳朵、鼻子	怪老头系列：耳朵、鼻子
爸爸就是爸爸	怪老头系列：爸爸就是爸爸
时间旅行少女～真理、和花与8名科学家~
猎天使魔女：血色命运	魔兵惊天录：嗜血宿命	Bayonetta:BloodyFate
爱丽丝梦游仙境	爱丽丝梦游仙境
辛普森一家第二十六季
阿涅斯的海滩	阿涅丝的海滩	沙滩上的华妲
快乐家家车
幻想的我
自古英雄出少年
目隐都市的演绎者	MekakuCityActors
北极移民	北极熊诺姆
魁拔妖侠传
通灵王	ShamanKing
黑骸	黑色残骸	Kuromukuro
黒執事BookoftheAtlantic
正义战士	正义战士
暗之末裔	爱上坏坏的死神	暗之末裔
终极蜘蛛侠第一季	终极蜘蛛侠
日本动画（人）展览会	日本动画人博览会
我和我的莫顿自行车	Moultonogmeg
降世神通：科拉传奇第三季
上课小动作OAD：倒棒游戏&猫	邻座同学是怪咖OAD
真盖塔世界的最终日	真盖塔世界的最终日
芭比之长发公主	芭比娃娃之长发公主
排球少年第三季	排球第三季	ハイキュー烏野高校VS白鳥沢学園高校
蝙蝠侠大战急冻人	蝙蝠侠之冰点危机
成龙历险记第三季
独角兽U	公主的独角兽	UtheUnicorn
X战记
阿尔法9号上的可怕生物	α-9之惧
哆啦A梦：大雄的平行西游记	Doraemon:NobitanoPararerusaiyûki
哆啦A梦：大雄与惑星之谜	哆啦A梦：大雄与动物行星	Doraemon:NobitatoAnimarupuranetto
哆啦A梦：大雄与梦幻三剑士	Doraemon:Nobita'sFantasticThreeMusketeers	Doraemon:Nobitatomugensankenshi
茄子：安达卢西亚之夏	Nasu:SummerinAndalusia
哆啦A梦：大雄与机器人王国	Doraemon:Nobitatorobottokingudamu
森林好小子	森林好小子	ForestBoy
药师寺凉子怪奇事件簿	Ryoko'sCaseFile
星际宝贝史迪奇	星际宝贝史迪奇
企鹅家族
游园惊梦
漂泊者	漂流武士
鬼神童子
叽哩咕与野兽	叽哩咕与野兽	Kirikouandthewildbeasts
漂泊者OAD	DriftersSpecialEdition	DRIFTERS
死神之帆	水手与死神
美少女战士Crystal第三季死亡变种篇	美少女战士水晶：DeathBusters篇
幸运卢克	幸运卢克
奇幻贵公子	GhostHunt	恶灵猎人
飞天巨桃历险记	詹姆斯和巨桃	飞天巨桃历险记
终极战役	终极战役	黑客帝国动画版
悠久之翼第二季	悠久之翼第二季
亚人第二季	亚人TV版第二季
旅行的机器人	RobotontheRoad	日本アニメ見本市第34話
猫和老鼠:飆风天王	猫和老鼠:飆风天王
日常工作第七季	天兵公园	日常参考
小叮当与精灵杯大赛	TinkerBellPixieHollowGames
人间失格剧场版
紧扣的星星（前篇）	紧扣的拇指（前篇）
日常ETV版	日常再编集版
沉默的未知	ArgentoSoma
芭比梦幻仙境之魔法彩虹	芭比梦幻仙境之魔法彩虹
海猫鸣泣之时	UminekonoNakuKoroni
荒唐童话	Jabberwocky
妄想学生会OVA	妄想学生会第16话
天体战士第二季	天体战士第二季
恋爱研究所	LoveLab
壳中少女：压缩	壳中少女	MardockScrambleTheFirstCompression
数码宝贝：滚球兽的诞生	光丘事件	Digimon:TheMovie
生存游戏社	2J火力以下枪战社	Sabagebu
花物语	ハナモノガタリ	Hanamonogatari
来自风平浪静的明天	来自风平浪静的明日	NaginoAsukara
剧场版魔法少女小圆后篇永远的故事	PuellaMagiMadokaMagicatheMovie:Eternal
猫的协奏曲	猫的协奏曲
蓝宝石之谜高清重制版	海底两万里高清重制版	不可思议的海之娜迪亚高清重制版
阿瓦隆	欢迎光临虚拟天堂	网络杀人游戏
春&夏事件簿：春太与千夏的青春	春&夏推理事件簿：春太与千夏的青春
人参王国
胡须鸡仔	胡子小鸡	鸡叔噼哟
翼神传说	翼神世音	ラーゼフォン
最后的把戏	TheLastTrick	最后的把戏
蜡笔小新之布里布里王国的秘密宝藏	蜡笔小新：不理不理王国的秘宝	蜡笔小新剧场版2：布里布里王国的宝
神是中学生	Kamichu	神中
微观小世界第一季	微小世界	Minusculeミニスキュル〜小さなムシの物語〜
麦太家居万能侠	麦太扭花臣（港）
苍狼传说	LegendoftheBlueWolves
四叠半神话大系：恋爱与垂钓之地面潜航艇	四叠半神话大系特典：地面潜航艇3
怕怕不怕	PapaisaCrocodile
少女与战车OVA爱里寿·WAR
堀桑与宫村君OVA	堀与宫村OVA	HORI-sanToMIYAMURA-kunOVA
X战警	X战警
可爱的茧	可爱的毛虫
新网球王子	新网球王子	ThePrinceofTennis
巴哈姆特之怒GENESIS	神击的巴哈姆特GENESIS	ShingekinoBahamut:Genesis
真实之泪
水星领航员第3季	水星领航员第三季
俺物语	MyLoveStory	OreMonogatari
逮捕令第二季
最游记RELOAD埋葬篇
GENIUSPARTY
南家三姐妹OAD3夏日假期	夏日假期
玩具总动员4	反斗奇兵4
起着风
變身男孩
十二生肖守护神	十二生肖爆烈戰士	TheTwelveWarriorsBakuretsuEto-ranger
无头骑士异闻录第二季：承OVA	无头骑士异闻录×2转我的心是火锅的形状
狼与香辛料	SpiceandWolf	Ôkamitokôshinryô
阿莱蒂公主	想当灰姑娘的公主	PrincessArete
小鲤鱼历险记
巷说百物语	京極夏彥巷說百物語	KousetsuHyakuMonogatari
青蛙军曹第一季	Keroro军曹	KeroroGunsô
橱柜童子	木橱童子	Tansuwarashi
更换电池	机器人与孤独婆婆
变形金刚：超能勇士	百变金钢	超能勇士
FrontInnocent
漆黑的子弹	黑色的子弹	黒の銃弾
神兽金刚
火童
银幕黑塔利亚	APH国家拟人剧场版
大话三国
黑衣警探	黑衣人动画版	黑衣警探
宝葫芦的秘密	飞天小葫芦	魔法小葫芦
恐色症	恐色症
乐高星球大战：学徒危机	乐高星球大战：学徒危机
武林外传动画版
神厨小福贵
扑杀天使	扑杀天使朵库萝	Bokusatsutenshi
亚人2：冲突	亚人剧场版2
小柴豆
三毛流浪记
黑礁：罗贝尔特的复仇	黑礁第三季	ブラック・ラグーンロベルタズ・ブラッド・トレイル
神奇宝贝剧场版：光轮的超魔神胡巴	PokémontheMovieXY:RingnoChomajinHoopa
我老婆是学生会长
蜡笔小新：呼风唤雨金矛之勇者	蜡笔小新：风起云涌的金矛勇	蜡笔小新剧场版16
天降之物	天降之物
飞天小女警2016第一季	霸王美少女	ThePowerpuffGirls
午夜之眼2	GokuMidnightEyeII
名侦探柯南：少年侦探团七分钟特辑	谜一般的杀人计划
我的青春恋爱物语果然有问题OVA	こちらとしても彼ら彼女らの行く末に幸多からんことを願わざるを得な
银魂爱染香篇后篇	银魂°OAD
宠物小精灵XY最强MEGA进化	最强百万进化～行动～
呼风唤雨会唱歌的屁股炸弹	クレヨンしんちゃん嵐を呼ぶ歌うケツだけ爆弾
飙速宅男第二季	弱虫脚踏板第二季
历史机关	BUREAUOFPROTOSOCIETY	日本アニメ見本市第29話
美少女战士Crystal第二季黑色月亮篇	美少女战士水晶：BlackMoon篇
海贼王剧场版9：冬季绽放的奇迹之樱	乔巴传记：绽放在寒冬的奇迹樱花
向阳素描×365	向阳素描×365
馒头日记
百武装战记	Hundred
山口山战记之太阳井	山口山战记之太阳井
麻辣女孩
我的狼人男友	脏爪爪
奇人密码：古罗布之迷	TheARTI:EnigmaoftheAncinetLop
虫师续章荆棘之路	虫师续章特别篇	虫师第二季特别篇
我叫MT第三季
快乐方程式	LEVEL－C
镜子面具	镜子面具	镜面具
小蚂蚁之环球大冒险	StarAnt-GlobalAdventure
左右脑
魔动王最后的魔法大战	MadououGrandzort:SaigonoMagicalTaisen	魔动王最后的魔法大战
海贼王剧场版6：狂欢男爵和神秘岛	狂欢男爵和神秘岛
微笑的鱼	Weixiaoderyu	AFishwithaSmile
马达加斯加企鹅第三季	马达加斯加企鹅第三季
有时可能是列车	有时可能是列车
瑞克和莫蒂法庭互喷
三个火枪手	AnimeThreeMusketeers	三剑客
欢乐树的朋友们：赶尽杀绝	快乐森林之赶尽杀绝	欢乐树的朋友们：赶尽杀绝
伤物语3：冷血篇	KizumonogatariPart3:Reiketsu-hen
老鼠约翰	老鼠约翰
芭比梦幻仙境之彩虹仙子	芭比之梦幻仙境
唱K小鱼仙第一季	MermaidMelody:PichiPichiPitch	人鱼的旋律
芭比之十二个跳舞的公主	十二个跳舞的公主	十二芭蕾舞公主
龙珠·改	DragonBallKai	龙珠改
加速世界OVA#EX01Reverberation；残响	AccelWorldOVA#EX01Reverberation	アクセル・ワールド-銀翼の覚醒-
摇曳百合2	摇曳百合第二季	轻松百合第二季
枪心剑刃	枪与剑
摩登原始人：石器时代大乱斗
拉曼查的堂·吉诃德	堂·吉诃德	拉曼查的堂·吉诃德
塔奇克马的日常	攻壳机动队：塔奇克马的日常	Tachikomanahibi
假如我是武松
贫乏神来了	Binbou-gamiga
ALDNOAH.ZERO第二季	ALDNOAH.ZERO第2期
妖精的尾巴第二季	フェアリーテール
境界线上的地平线	KyokaiSenjonoHorizon	HorizonontheMiddleofNowhere
心灵侦探八云	心灵侦探八云	PsychicDetectiveYakumo
日常工作第四季	天兵公园	日常参考
午夜之眼	GokuMidnightEye
小叮当与失去的宝藏	廷克·贝尔与失去的宝藏	奇妙仙子与失落的宝藏
全职高手
牙刷家族	TheToothbrushFamily
最后的独角兽	最后独角兽	独角飞马
地狱少女二笼	地狱少女（第二季）	JigokuShoujoFutakomori
降世神通：科拉传奇第二季	降世神通：科拉传奇第二卷神灵	LegendofKorra:Book2Spirit
终结的炽天使	SeraphoftheEnd	OwarinoSeraph
军火女王第二季	军火女王第二季
攻壳机动队：崛起1	GhostintheshellARISEborder:1GhostPain
蝙蝠侠大战德古拉	蝙蝠侠大战德古拉
名侦探柯南OVA10：怪盗基德孤岛决战	怪盗基德陷阱之岛
我的女神OVA	AhMyGoddessOVA	我的女神OVA版
美少女战士R剧场版：花朵的约定	星夜传奇	美少女战士剧场版花朵的约定
校园惊魂记	公仔总动员：校园惊魂计	TerkelinTrouble
傀儡公主	PuppetPrincess
神探加杰特第一季
无法逃离的背叛	无法挣脱的背叛	背叛知道我的名字
口袋妖怪：原初之章	神奇宝贝THEORIGIN	宠物小精灵THEORIGIN
女神异闻录3剧场版第四章冬日重生
空想新子和千年的魔法	新子与千年魔法	MaimaiShinkotoSennennoMahô
乐高星球大战：帝国反击战
刺客聂隐娘前传
天马行空
大闹天宫3D	TheMonkeyKing3D
机动战士高达0080：口袋里的战争	机动战士Gundam0080口袋里的战争
正义联盟	正义超人联盟
戒烟25法	戒烟25法
霍顿与无名氏	霍顿与无名氏
织田信奈的野望	织田信奈的野望
很黄很暴力	很黄很暴力
向阳素描	日向素描	HidamariSketch
少女革命：思春期默示录	Utena:Adolescence
BB有心事	BB与我	反斗小宝贝
大英雄狄青
来自马努斯岛的声音
四月是你的谎言OAD：MOMENTS	YourLieinAprilOAD:Moments	ShigatsuwaKiminoUsoOAD:MOMENTS
隐之王	隐王
光环：致远星的陷落第一季
姆明一族	楽しいムーミン一家	噜噜咪一家
青之驱魔师剧场版	BlueExorcisttheMovie
鬼灯的冷彻OAD1	HoozukinoReitetsuOAD
燕尾蝶	BOBOTOTO-燕尾蝶
萌菌物语	豆芽小文	明菌物语
三毛流浪记
永远永远爱你	你看起来好像很好吃2	고녀석맛나겠다2:함께라서행복해
羁绊者	KIZNAIVER
无头骑士异闻录：天下泰平
恐龙葛蒂	恐龙葛蒂
鲍伯的生日	鲍伯的生日
鬼神传	Onigamiden	LegendoftheMillenniumDragon
无爱之战	ラブレス
红气球	TheRedBalloon
猫儿历险记	富贵猫	贵族猫
月光旅程第二季：着陆	月光之旅	月亮的距离
我的代表	怪老头系列：我的代表
青春之旅OAD-unwritten-	闪烁的青春-unwritten-	AoHaruRide-unwritten-
小明和王猫
异国迷宫的十字路口	IkokuMeironoCroisée	Lacroiséedansunlabyrintheétranger
少年泰坦出击第一季
黑猫警长之翡翠之星	黑猫警长2：翡翠之星	黑猫警长2：决战“翡翠之星”
电锯女仆2	电锯女仆2
阿凡提的故事之比智慧	第四集：比智慧
时间飞船	Timebokan	时间飞船
红领巾侠
糖果男孩
潜行吧奈亚子	HaiyoreNyaruko-san	袭来美少女邪神
钢铁侠：噬甲危机	钢铁侠：纳米魔崛起	钢铁侠：崛起的噬甲病毒
阿凡提的故事之偷东西的驴	第五集：偷东西的驴
哆啦A梦：大雄与翼之勇者	Doraemon:Nobitatotsubasanoyûshatachi	Doraemon:NobitaandtheWingedBraves
萨米大冒险2	森美海底历险2	小海龟大历险2
济公斗蟋蟀
飙速宅男剧场版
血界战线OAD	血界战线国王餐厅的国王	KekkaiSensenOAD
梦的机器
丛林大反攻2	狩猎季节2	打猎季节2
守望先锋：归来
薄樱鬼：碧血录	薄樱鬼第二季	薄樱鬼～新选组奇谭～第二季
蜘蛛侠	蜘蛛俠动画版
德克斯特的实验室第一季	Dexter'sLabSeason1	DexterdeShiyanshiSeason1
猫和老鼠-海盗寻宝	猫和老鼠--别碰胡须
蜡笔小新otakebe春日部野生王国	蜡笔小新·春日部野生王国	呐喊春日部野生王国
臭美公子的追求	由于有点印象
天使的心跳：另一个后记
和尚与飞鱼	修士与鱼	僧侣捕鱼
潮与虎	魔力小马	UshiotoTora
蓝调之歌	悉多的蓝调	蓝调之歌
泡芙小姐第二季	MissPuffSeason2
泡芙小姐第三季：温暖归来	泡芙小姐3	MissPuffSeason3
荒唐人的梦	Sonsmeshnogocheloveka	TheDreamofaRidiculousMan
龙珠GT	七龙珠GT
偶像大师灰姑娘女孩第二季	TheIdolmasterCinderellaGirlsSeasonTwo
小鹿斑比2	小鹿班比2
魅影巨神	THEビッグオー	TheBigO
RDG濒危物种少女	RDG红皮书女孩
愤怒的小鸟卡通片第一季	愤怒的小鸟动画
丁丁历险记之太阳神的囚徒	丁丁历险记之太阳神庙	TintinandtheTempleoftheSun
虞美人盛开的山坡·父与子300天的战争	虞美人的山坡上·父与子300天的战争
宠物小精灵：去往超克的时空	钻石珍珠：圣灵兽	宠物小精灵剧场版去往超克的时空
功夫熊猫：盖世传奇第三季	无功夫熊猫：非凡传奇第三季	功夫熊猫：大侠传奇第三季
小飞侠彼得潘	彼得·潘	小飞侠
有你的小镇	小镇有你	有你的小镇TV版
美少女战士Crystal	美少女战士：水晶	PrettyGuardianSailorMoonCrystal
哆啦A梦：新·大雄的宇宙开拓史	哆啦A梦09剧场版：新版大雄的宇宙开拓史	Eigadoraemon:Shin.Nobitanouchûka
爆音少女	Bakuon
蝙蝠侠：麻烦重重	蝙蝠侠：四面楚歌
船长哈洛克	宇宙海盗夏罗古	宇宙海贼哈洛克剧场版
熊的传说2	熊兄弟2
女神异闻录3剧场版第二章仲夏骑士之梦	ペルソナ3theMovie#2MidsummerKnight'sDream
宇宙战舰大和号2199	SpaceBattleshipYamato2199
芭比之蝴蝶仙子	芭比梦幻仙境之蝴蝶仙子
魔法科高校的劣等生	魔法科高中的劣等生	MahoukaKoukounoRettousei
乡巴佬	城里老鼠和乡下老鼠
华尔兹二重奏
空中秋千	KuuchuuBuranko
天降之物剧场版：发条装置之哀女神	剧场版天降之物发条装置之哀女神
魔奇少年	天方魔谭MAGI	魔笛MAGI
异国色恋浪漫谭	异国色恋浪漫谭
银河铁道之夜	TheCelestialRailroad	FantasyRailroadintheStars
水星领航员OVA	水星领航员OVA
翼：东京默示录	TsubasaTokyoRevelations
海绵宝宝对大块头	海绵宝宝对大块头
最游记：给落选者的镇魂歌	最游记：给落选者的镇魂歌	SaiyukiRequiem
飞机总动员2：火线救援	飞机总动员：火线救援	飞机总动员：打火英雄
禽兽超人
魔豆传奇	PandaMonium
草原英雄小姐妹
太空丹迪第二季	SpaceDandySeason2
海贼王剧场版Z	海贼王剧场版:Z	航海王电影:Z
马达加斯加企鹅：行动
怪盗圣少女	怪盗St.Tail	圣少女
波蕾特的椅子	Poulette'sChair
怪猫菲力兹	小猫弗里茨
公牛费迪南德	公牛费迪南德
舞-乙HiME	Maiotome	My-Otome
阿凡提的故事之驴说话	第八集：驴说话
地狱少女三鼎	地狱少女三鼎
铁拳：血之复仇	TEKKENBloodVengeance
厄运葬礼	两个抬棺材的人
黑岩射手	BLACK★ROCKSHOOTER	ブラック★ロックシューター
我太受欢迎了该怎么办
苍蓝钢铁的琶音	苍蓝钢铁战舰	Arpeggioofbluesteel
少年正义联盟第二季
便所爱情故事	厕所的故事	厕所爱情故事
丹佛，最后的恐龙	丹佛，最后的恐龙
钻石王牌第二季	ダイヤのA2期	DiamondNoAce
幸运星OVA	LuckyStarOVA
花仙子	花仙子
魔卡少女樱特典：包在小可身上	包在小可身上
娼妓与野兽
芭比之胡桃夹子	芭比与胡桃夹子梦幻之旅	芭比与胡桃钳的梦幻之旅
亚尔斯兰战记OAD	阿斯兰战记OAD	亚尔斯兰战记外传
忍者神龟3	忍者龟3	忍者龟3时空武士
功夫料理娘	KungfuCookingGirls
南家三姐妹欢迎回来	南家三姐妹第三季
过猴山
The·奥特曼加卡鲁对奥特曼	日本アニメ（ーター）見本市系列第30话	日本动画展览会第30话
咕咚来了
新妹魔王的契约者第二季	新妹魔王的契约者BURST	TheTestamentofSisterNewDevilBurst
高飞家族
刺客信条：余烬
托马斯和朋友第一季	汤玛斯和朋友伟大的发现	托马斯和他的朋友们
足球小将剧场版：世界大决战Jr.世界杯	足球小将之世界级决战	CaptainTsubasaMovie04:TheGreatWorldCompetitionTheJuni
逮捕令第一季	警花逮捕令	辣妹逮捕令
终极复仇者2：黑豹的崛起	终极复仇者2：黑豹的崛起
超级无敌掌门狗：月球野餐记	酷狗宝贝1：月球野餐记	超级无敌掌门狗之月球旅行记
七大罪第二季	七原罪第二季	TheSevenDeadlySinsSeason2
这个男子捡到了人鱼
自画像	SelfPortrait
今天开始做魔王	Kyôkaramaô
小羊肖恩：美好时光	小羊肖恩：美好时光
只有神知道的世界	机神追女攻略	神之境界
乡巴佬希尔一家的幸福生活第二季	一家之主第二季	山丘之王第二季
百变之星	KaleidoStar	カレイドスター
钢丝钳
二维世界	二维电影	平面国
皮克斯动画短片合集2	皮克斯短片精选2
图书馆战争	ToshokanSensō	LibraryWar
丁丁历险记第三季	LesAventuresdeTintin
辛普森一家第四季	阿森一家第四季
创：战纪	创：光速战记	电子世界争霸战2
卑鄙的我：慌乱的小黄人3D
笨蛋·测验·召唤兽续篇	笨蛋·测验·召唤兽2
恶搞之家第二季	搞怪一家人第二季	格利芬一家第二季
罪恶王冠：失落的圣诞节	GuiltyCrown:LostChristmas
冰冻星球	冰冻星球	宇宙奇舰泰坦号
命运石之门23β：境界面上的缺失之环
百合熊风暴	百合熊岚	YuriKumaArashi
宇宙战舰大和号	UchûsenkanYamato	AsteroidShipIcarus
超决战贝利亚银河帝国	奥特曼大电影2012	赛罗奥特曼THEMOVIE超决战贝利亚银河帝国
GATE奇幻自卫队	Gate:JieitaiKanochinite,KakuTatakaeri
巨神兵在东京出现	巨神兵现身东京	巨神兵東京に現わる劇場版
没牙的老虎	老虎拔牙
不在他处，正是此地	成年女性的动画时间：不在他处，正是此地
铠甲勇士	铠甲战士之光影传奇	铠甲勇士之英雄传奇
妖精的尾巴：妖精学园不良君与不良妹
速写者	极速摄杀
斩首循环蓝色学者与戏言跟班
吊带袜天使	Panty&StockingwithGarterbelt
刺客信条：权势
马达加斯加的企鹅第二季	马达加斯加企鹅第二季
憨八龟的故事
星际恐龙	恐龙勇士	星际恐龙
紧扣的星星（后篇）	紧扣的星星（后篇）
熊猫京京
小玩具	反斗奇兵迷你Show：薯假包换	ToyStoryToons
AngeVierge	圣洁天使
狂野生活	狂野生活
松鼠的爱	松鼠之爱
13号病房	13号病房
妄想学生会2	妄想学生会第二季	SeitokaiYakuindomo*
恐怖僵尸猫
哈姆太郎	Hamtaro	TrottingHamtaro
风人物语	FuujinMonogatari	WindyTales
阿凡提的故事之神医	第三集：神医
阿凡提的故事之狩猎记	第九集：狩猎记
炎之蜃气楼	OVA*炎の蜃気楼～みなぎわの反逆者～
美女与野兽之贝儿的心愿	美女与野兽：贝儿的心愿
少女与战车OVA	GIRLSundPANZEROVA
疯狂农庄	疯狂牧场
安娜与贝拉	AnnaenBella
只要你说你爱我
年兽大作战	疯狂的年兽	Mr.Nian
尸兄第二季：我叫白小飞	尸兄第二季
金田一少年事件簿	Kindaichishônennojikenbo	YoungKindaichi'sCasebook
最终幻想15：兄弟
底特律金属城	重金摇滚双面人	重金属摇滚双面人
小野貓	小野貓
终极蜘蛛侠第四季	UltimateSpider-ManvstheSinister6	终极蜘蛛侠大战邪恶六人组
龙子太郎	TatsunokoTarô	TarotheDragonBoy
机动战士高达0079	MobileSuitGundam	MobileSuitGundam0079
哆啦A梦：大雄与风之使者	Doraemon:Nobitatofushigikazetsukai	Doraemon:NobitaandtheWindWizard
灼眼的夏娜2	ShakugannoShanaSecond	灼眼的夏娜2
功夫熊猫：盖世传奇第一季	功夫熊猫：非凡传奇第一季	功夫熊猫：大侠传奇第一季
大英贱闻录第一季
薄樱鬼
小叮当：羽翼之谜	奇妙仙子：冬森林的秘密	小叮当：冬日物语
仙履奇缘2：美梦成真	灰姑娘2：美梦成真	仙履奇缘2：美梦成真
名侦探柯南特典：通往大阪什锦煎饼的艰险之路	名侦探柯南M14特典	DetectiveConanMagicFile4
蓝精灵3：失落的村庄	蓝精灵3	超级蓝精灵：魔法重启
校园搞怪王
鹿铃	LuLing
驯龙记：伯克岛的守护者第二季	驯龙高手博客岛的守护者
逃离地球	地球人坏坏
在这世界的角落
库拉乌-幻之记忆	库拉乌-幻之记忆
巧舌如父	TheStorytellingShow
恰卜恰布	钢牙小鸡兵团	恰比恰比
青年黑杰克	青年怪医黑杰克	少年黑杰克
老鼠罐头工厂	老鼠罐头工厂
孤独的小猪
阿凡提的故事之寻开心	第十集：寻开心
人参果	孙悟空偷吃人参果
新装的门铃
时间之主	TimeMasters	时间之主
AD特警	优化警察档案	A.D特警
PunchLine
神薙	CrazyShrineMaidens
拖线狂想曲第一季	汽车闯天关：拖线狂想曲	汽车总动员：大话板牙
史上最强弟子兼一
大雄的怀念奶奶	奶奶的思念	奶奶的回忆
恐龙家族	恐龙家族
樱Trick	SakuraTrick
红壳的潘多拉TV版
翠星之加尔刚蒂亚	翠星的伽鲁冈缇亚	GargantiaontheVerdurousPlanet
唐老鸭俱乐部
忍者猫	SamuraiPizzaCats	功夫猫党
勇敢骑士兔八哥	勇敢骑士兔八哥
福星小子2：绮丽梦中人	福星小子2：绮丽梦中人	UruseiYatsura2:BeautifulDreamer
汤姆的艳遇
无限斯特拉托斯2	无限斯特拉托斯第二季	InfiniteStratos2
前进吧登山少女	女孩子们的登山物语	向山进发
Q版三国之三小强
中国惊奇先生
男性游戏	VirileGames	TheMaleGame
迷宫物件	TwilightQ	曙光Q
驯龙骑士	天平与剑	渣斯汀大任务
失落的宇宙	失落的宇宙	ロスト・ユニバース
天才嘉年华2	ジーニアス・パーティ・ビヨンド
青之六号	BlueSubmarineNo.6
恶魔奶爸	魔王奶爸	魔王的父亲
绿巨人大战	绿巨人大战金刚狼、索尔	绿巨人大战金刚狼
太空堡垒
埃德蒙
谁的本领大
不容异说3：最终的解决方案	不容异说3：最终的解决方案
骨碎龙传说	驯龙记短片：骨碎龙传说	驯龙高手短片：骨碎龙传说
LoveLiveOVA	LoveLiveSchoolIdolProjectOVA
被狙击的学园	通灵学园大作战	瞄准学校
神秘世界历险记2	奇异家族2	Yugo&Lala2
减肥时代	减肥时代
丁丁历险记第二季	LesAventuresdeTintin
乐高星球大战：新尤达编年史之天行者冲击
魔法少女奈叶A's	MagicalGirlLyricalNanohaA's
银河守护者第一季	银河护卫队	银河护卫队动画版
三毛流浪记	WinterOfThreeHairs
成龙历险记第四季
麻辣女孩：时间危机	麻辣女孩：超时空任务
哆啦A梦：大雄的宇宙开拓史	Doraemon:NobitanoUchûkaitakushi
哆啦A梦：大雄的魔界大冒险	Doraemon:Nobita'sGreatAdventureintheWorldofMagic	Doraemon:Nobitanomakaidaibôken
哆啦A梦：大雄的创世日记	Doraemon:Nobita'sGenesisDiary	Doraemon:NobitanoSouseinikki
哆啦A梦：大雄的太阳王传说	哆啦A梦：太阳王传说	Doraemon:NobitaandtheLegendoftheSunKing
奇诺之旅活着的目标生活继续	奇诺之旅：生活继续	Kino'sJourney:Lifegoeson
圣斗士星矢:天界篇序奏-Overture	SaintSeiya:TheHeavenChapter-Overture	圣斗士星矢:天界篇序奏-Overture
道成寺	道成寺	DojojiTemple
最近，妹妹的样子有点怪	最近我的妹妹有点怪	Recently,mysisterisunusual.
龙珠改魔人布欧篇
跟苏斯学修理第三季	怪诞小镇迷你剧第三季
机动战士高达THEORIGINIV命运前夜
金刚狼与X战警	金刚狼和X战警
俗·再见，绝望先生	ZokuSayonaraZetsuboSensei
超戰士擊破勝利的勇士是我	DoragonbôruZ11:SûpâsenshigekihaKatsunowaoreda
饿沙罗鬼	Gasaraki	饿沙罗鬼
托马斯和朋友们：多多岛之迷失宝藏	托马斯和朋友们多多岛之迷失宝藏	汤马仕小火车之索多岛迷失宝藏
熊猫家族	熊猫、小熊猫	PandaGoPanda
机械女警
四月一日灵异事件簿：春梦记后篇	XXXHOLiC:Shunmuki-Kôhen
赤发的白雪姬第二季	红发的白雪公主第二季	SnowWhitewiththeRedHairS2
只有神知道的世界第2季	神のみぞ知るセカイ第2シーズン
起风了：1000日的创作记录	起风了：1000天的创作记录
英俊的茂雄	英俊的茂雄
热带雨林的爆笑生活豪华篇	热带雨林的爆笑生活DELUXE
福星大嘴鸟	福星大咀鸟	Kyoro-chan
三千里寻母记	寻母三千里	万里寻母
RedShoesandthe7Dwarfs
三眼神童	三眼神童	恶魔岛的王子：三眼神童
熊猫百货商店
每个孩子	弃婴	Chaqueenfant
雾中小站	雾中小站
火星异种	火星任务	TerraFormars
学战都市Asterisk第二季	TheAsteriskWarS2
降世神通第二季	AVATARBOOK2	AvatarBookII
雪之少女	カノン
泡芙小姐第四季	泡芙小姐4欲望季	MissPuffSeason4
皮克斯动画短片合集1	皮克斯短片精选1
青山刚昌短篇集	あおやまごうしょうたんぺんしゅう
樱时	TimeofCherryBlossoms
主義之外	Beyond-ism
哑巴乐园	蠢货之地
东京猫猫	东京喵喵	猫猫战队
阿曼动画之超级无敌掌门狗系列1	阿曼动画之酷狗宝贝系列1
名侦探柯南OVA3：柯南、平次与消失的少年	柯南、平次與失蹤的少年	名侦探柯南OVA3-柯南与平次与消失的少年
滑头鬼之孙零·泪·雪	零•泪•雪
圣母在上	玛利亚的凝望	Mariasamagamiteru
藏獒多吉	TheTibetanDog
金色琴弦	金色的琴弦
无敌钢铁侠	无敌钢铁侠
宠物小精灵：幻影的霸者索罗亚克	剧场版宠物小精灵钻石·珍珠幻影之霸者索罗亚克	宠物小精灵2010剧场
幻想嘉年华SpecialSeason	カーニバル・ファンタズムスペシャルシーズン
漫画少女	Mangirl
四叠半神话大系：地面潜航艇，前往南极	四叠半神话大系特典：地面潜航艇1
很帅很可爱宣言	很帅很可爱宣言
辛普森一家第二十五季
柯南的推理教室深海的鉴定	柯南M11特典
阿里巴巴2所罗门封印	阿里巴巴：所罗门封印
灼眼的夏娜3	灼眼のシャナIII	灼眼的夏娜3
电梯口	Outsideoftheelevator
名侦探柯南OVA7：来自阿笠的挑战书阿笠对决柯南和少年侦探团	名侦探柯南OVA7：来自阿笠的挑战书阿笠VS柯南&少年侦探团
百变马丁	马丁的早晨第二部	MagicMatin
101忠狗续集：伦敦大冒险	101Dalmatians:TheAnimatedSequel
泰迪熊2	熊麻吉2	贱熊2
宅男斯坦利的发条生活
机动警察：废弃物13号	WXIII:PatlabortheMovie3
爱杀宝贝	Baby,PleaseKillMe	KillMeBaby
海绵宝宝第十季
云端的日子
东京糖衣巧克力	东京云石巧克力	TokyoMarbleChocolate
超元气三姐妹	三人混战	超元气三姐妹
南方公园第二十季
果实的谋杀	奇异果
纸片战记
反叛的鲁路修特别篇：零之镇魂曲	CodeGeass:LelouchoftheRebellion-SpecialEdition-ZeroRequiem
风雪山神庙
小王子	TheLittlePrince	Lepetitprince
安娜斯塔西娅	安娜塔西亚	安娜传奇之真假公主
超时空要塞Macross	ChôjikûyôsaiMacross	超时空要塞Macross
热诚传说：导师的黎明	情热传说	TalesofZestiria导师的黎明
X战警：进化第一季
海豚便利店	GrrlPower
吹响悠风号特典：吹奏乐部的日常	奏响吧上低音号特典	吹响上低音号特典
101斑点狗第一季	101斑点狗
马达加斯加的圣诞	荒失失奇兵过圣诞	圣诞快乐，马达加斯加
另一种爱	另一种爱
傻瓜特工大冒险
多啦A梦族：奇怪的点心娜娜王国	机器猫多啦A梦七小子之奇怪的点心娜娜王国
火之鸟
海贼王剧场版8：沙漠公主与海盗们	航海王：阿拉巴斯坦战记~沙漠王女与海贼们	ONEPIECE剧场版沙漠王女与
冬追夏赶
食戟之灵OVA塔克米下町之战
辛普森一家第十二季
命运石之门0	命运石之门Zero
天使禁猎区	AngelSanctuary
蜡笔小新之黑暗珠珠大追击	CrayonShin-chanankokutamatamadaitsuiseki
小神童	功夫熊猫美国山寨版
四叠半神话大系：地面潜航艇，前往女性温泉，闺房调查团桃色探索	四叠半神话大系特典：地面潜航艇2
变形金刚第三季	变形金刚
泰山归来：险战丛林	新人猿泰山	泰山归来：人猿大战
绝无仅有-oneoff-
企鹅帮圣诞恶搞历险记	马达加斯加之企鹅帮欢闹圣诞	马达加斯加之企鹅帮
异蔷薇战争
蔷薇少女	蔷薇少女
上海大龙	ShanghaiDragon
侵略乌贼娘	Theinvadercomesfromthebottomofthesea	侵略花枝娘
兔子，等着瞧	Nu,pogodi	兔子，等着瞧
钢铁之泪	钢铁泪痕	钢之殇
邪恶新世界	从此没有过着幸福快乐的日子	反斗仙屐奇缘
摩登原始人第二季	石头城乐园第二季
超时空要塞：可曾记得爱	超时空要塞Macross：可曾记得爱	ChôjikûyôsaiMacross:Aioboeteimasuka
ThisIsNotReal
一起一起这里那里	Acchikocchi
超级无敌掌门狗：剃刀边缘	酷狗宝贝3：剃刀边缘	超级无敌掌门狗之九死一生
美女闯通关	幻世空间	美女闯通关
谢谢小花猫
人人都爱催眠蛤蟆
南家三姐妹甜品别腹	南家三姐妹OAD
未来忍者	蒙面飞侠
火影忍者~鼬真传~	火影忍者疾风传：鼬真传篇~光与暗~
女神异闻录圣洁之魂	ペルソナ〜トリニティ・ソウル〜	女神异闻录圣灵之魂
台风的诺尔达	TyphoonNoNoruda
开心宝贝之开心超人	开心宝贝第二部
机器肉鸡第二季	机器肉鸡
束缚自由
最游记RELOADGUNLOCK	最游记第三部	SayukiRELOADGUNLOCK
豆腐小僧	小豆腐大冒险	豆富小僧3D版
百变孙悟空	TheFlyingSuperboard	新编西游记
茄子：旅行箱中的候鸟	茄子旅行箱中的候鸟
夏洛的网	夏洛的网	神奇小蛛网
间谍亚契第二季
瑞克和莫蒂的大灾难
零之使魔FINAL	零之使魔F
小公主苏菲亚第一季
仲夏夜之梦	AMidsummerNight'sDream	仲夏夜之梦
别抱我，我害怕
华丽的挑战	下一站巨星	SKIPBEAT
黑血兄弟	BlackBloodBrothers	黑血兄弟
宠物小精灵：七夜的许愿星	宠物小精灵剧场版：七夜的许愿星	劇場版ポケットモンスター七夜の
爱情和蛋	煎蛋与爱人
小巨人3D
百日蔷薇	HyakujitsuNoBara	百日蔷薇OVA
EVA：绝密冲击	日本アニメ見本市第12話	日本动画展览会第12话
罗摩衍那：史诗	PrinzRama-ImReichderMythenundLegenden
龙珠Z剧场版9：银河面临危机身手不凡的高手	DragonBallZMovie9	銀河面臨危機身手不凡的高手
永远的忍者神龟
魔女的使命	WitchCraftWorks
恶搞之家第九季	搞怪一家人第九季	格利芬一家第九季
天才麻将少女：全国篇	天才麻将少女第三季
庵野先生与我们的莽撞挑战日本动画人展览会	庵野先生与我们的莽撞挑战日本动画人展览会
灰姑娘	仙履奇缘
企业战士
喜羊羊与灰太狼之古古怪界大作战	喜羊羊与灰太狼(第281-340集)
未来蝙蝠侠：小丑归来	未来蝙蝠侠：小丑归来
棒球大联盟OVA：向着梦的瞬间	棒球大联盟OVA夢の瞬間へ
武器种族传说	ElementalGelade	ErementarGerad
小孤儿	小孤儿
黄金拼图	黄金嵌片	GoldenMosaic
宠物小精灵：结晶塔的帝王	结晶塔的帝王
妄想学生会OAD2	妄想学生会第15话
动量和惯性的故事	本性与人性的故事
宫崎骏和吉卜力美术馆	宫崎骏与吉卜力美术馆	三鹰之森吉卜力美术馆
托尔与洛基：血亲	托尔与洛基：血兄弟
末日之战	Z计划	Planzet
这就是僵尸吗	KorewaZombieDesuka	这样算是僵尸吗
日常工作第二季	天兵公园	日常参考
太空黑猩猩	猩战前传	太空飞猩
机动战士高达UC	机动战士钢弹UC	MobileSuitGundamUnicorn
文学少女剧场版	GekijôbanBangakushôjo	剧场版文学少女
帕丁顿熊
平成破廉耻学园	HeiseiHarenchiGakuen	Modern-EraShamelessSchool
利维坦
粉红豹	粉红色的芬克
罗德斯岛战记	罗德斯岛战记：灰色魔女传	罗德岛战记OVA
美国金曲	美国流行乐
蓝海少女	海之少女	Amanchu
绝地逃亡	跨境追捕	跳跃追踪
Emoji大电影：展现自我	Emoji大电影	TheEmojiMovie
游戏王剧场版	次元的黑暗面
Thomas&Friends:DayoftheDiesels	汤马仕小火车之智斗柴油车
源氏物语千年纪	TheTaleofGenji	Genjimonogatarisennenki:Genji
萨米大冒险	森美海底历险	小海龟大历险
七大罪OAD外传班德特·班	TheSevenDeadlySinsOAD	NanatsunoTaizaiOAD
查理和萝拉	查理和萝拉
海贼王剧场版5：被诅咒的圣剑	海贼王剧场版5-被诅咒的圣剑
铁臂阿童木第二季	小战士
英雄联盟：新的曙光	LeagueofLegendsCinematic:ANewDawn	英雄联盟CG：新的曙光
伪恋第二季	伪恋：	NisekoiSeason2
幸腹涂鸦	GourmetGirlGraffiti	KoufukuGraffiti
狼雨	狼雨
新大头儿子和小头爸爸之秘密计划	新大头儿子和小头爸爸大电影	SecretPlans
四月一日灵异事件簿·笼	四月一日灵异记事簿·笼	xxxHOLiC・笼
与恐龙同行	与龙同行3D大电影
小红脸和小蓝脸
神奇宝贝钻石与珍珠	宠物小精灵钻石&珍珠	神奇宝贝DP
岩窟王	Gankutsuou	TheCountofMonteCristo
噗哔啵～来自未来～
圣诞传说	圣诞节	Rozhdestvo
全职猎人OVA2	全职猎人OVA2
青之驱魔师OVA：小黑出走记	青之驱魔师第11.5话特别番外篇	BlueExorcistOVA:RunawayKuro
这是南瓜大王哦查理·布朗	这是个大南瓜哦查理·布朗	史努比卡通：万圣节南瓜头
烤焦面包	烤焦面包
阿里巴巴：大盗奇兵	AlibabaandTheThief
宠物小精灵：水都的守护神-拉帝亚斯与拉帝欧斯	皮卡丘英雄
月光旅程第一季：升空	月光之旅	月亮的距离
泰山2	泰山2
天堂餐馆	RistoranteParadiso	天堂餐館
葫芦兄弟	葫芦兄弟电影版	CalabashBrothers
Aggressive烈子	爆发吧烈子
小森同学拒绝不了	小森拒绝不了	小森同学拒绝不了
钢铁侠2	铁甲奇侠2	钢铁人2
新妹魔王的契约者特典	TheTestamentofSisterNewDevilminiOVA	ShinmaiMaounoTestamentminiOVA
幽灵又出现	幽灵又出现
祖鲁猫	祖鲁猫
我叫MT第四季
乐高漫威复仇者联盟：重新集结
拥抱春天的罗曼史
管家后宫学园	LadiesvsButlers
奔向地球	Terrae...	TowardtheTerra
妖精的尾巴zero	FAIRYTAILZERO
名侦探柯南OVA12：传说中的球棒的奇迹	青山刚昌短篇集：传说中的球棒	名侦探柯南OVA12：Excalibur的奇迹
青春之旅TV未放送第13话	青春之旅“烟火大会篇”	青春之旅OAD2
四月一日灵异事件簿剧场版：仲夏夜之梦	四月一日灵异记事簿剧场版：仲夏夜之梦
留长发的女人
低能侦探	乌龙侦探	低能侦探
小红帽与狼Fetch
欢乐树的朋友们	快乐森林	危险朋友
唐老鸭打高尔夫	唐老鸭打高尔夫
开心超人	开心宝贝大电影	HappyHeroes
巨星总动员	乐一通反斗特工队	华纳巨星总动员
玩具总动员之惊魂夜	玩具总动员之恐怖故事	ToyStoryToons
百变机兽之洛洛历险记	山寨版变形金刚	百变鸡兽
哈皮父子	happyfatherhappyson
拔萝卜
特工次时代
旋转少女	翻转女孩	TheRollingGirls
小红帽	欺骗小红帽的真实故事	小红帽后现代版
小鸟小鸟
晴空战士	为她打开天空	WonderfulDays
雷锋的故事
中二病也要谈恋爱闪耀的圣爆诞祭	中二病也要谈恋爱第13话：闪耀的…圣爆诞祭	中二病でも恋がしたい
彩虹小马：小马国女孩之彩虹摇滚	小马国女孩2：彩虹音爆	小马国女孩2：彩虹能量
欲望门	PortalofDesire
鬼公子炎魔ova	鬼公子炎魔
DimensionW~维度战记~	DimensionW	维度战记
回声——小兔淘淘的故事
网球并不可笑嘛	女高网球部
刀剑乱舞
咎狗之血	咎狗之血
没有影子的人	TheManwithoutShadow
Exodus	白箱剧中剧OVA
老狼请客
装甲骑兵之佩鲁森档案	装甲騎兵ボトムズペールゼン·ファイルズ	装甲骑兵：佩尔森档案
查理布朗和史努比秀第一季	史努比
OVERLORD短篇	不死者之王短篇	OVERLORDSP
我是大哥大	我是大哥大	今日我至叻
旋风管家	Hayatenogotoku	HayatetheCombatButler
神奇宝贝：皮卡丘的夏日祭典	PikachunoNatsumatsuri	宠物小精灵：比卡超的夏日祭典
神奇宝贝：皮卡丘的鬼怪狂欢节	PikachunoObakeCarnival	宠物小精灵之古堡狂欢
海贼王特别篇萨博的故事	三兄弟的羁绊奇迹的再会和被继承的意志
奇诺之旅：疾病之国-ForYou-	Gekijôbankinonotabi:Byôkinokuni-Foryou	奇诺之旅：疾病之国-ForYou-
钟表匠诺克西米利安	沃土特别篇
Simorgh
高校星歌剧	ハイスクールスター・ミュージカル
幸存的希德	冰河世纪番外篇：幸存的希德
子宫战士	UTERUSMAN
刺痛我	PiercingI
魔神英雄传2	新魔神英雄傳
童年记趣	飞翔的梦	TheFlyingSneaker
偶像战域	ICONICFIELD	日本アニメ見本市第21話
加斯帕·莫雷罗神秘探险记	TheWorldofJasperMorello	加斯帕·莫雷罗神秘探险记
天空之艾斯嘉科尼	圣天空战记	TheVisionofEscaflowne
星期一闭馆	星期一闭馆
奥特曼	初代奥特曼	Ultraman
狂野大自然	野蛮任务	兽猛猛奇兵
超时空要塞ZERO	MacrossZero
偶像大师XENOGLOSSIA
海绵宝宝第九季
Free特典
红伤骑士X	惊鸿骑士杰克斯	ScaredRiderXechS
辛普森一家第二十三季	辛普森一家
小熊猫学木匠
平面国	二维国	平面国
路人女主的养成方法：爱与青春的服务回
娜美篇航海士的眼泪与牵绊	海贼王特别篇SP21
肚子痛的核电站君
死神剧场版3黑色褪去呼唤君之名	死神剧场版3黑色褪去呼唤君之名
我家有个狐仙大人	WagayanoOinari-sama.
梦之蜡笔王国	蜡笔小王国	CrayonKingdomofDreams
境界线上的地平线Ⅱ	HorizonontheMiddleofNowhereⅡ	KyoukaisenjounoHorizonⅡ
爱探险的朵拉第一季	小小冒险家朵乐
无限地带23Ⅱ：告诉我你的秘密	Megazone23Part2:ProjectCard	Megazone23Part2:HimitsuKudasai
赤色挽歌	Sekishokuerejî
龙与虎OVA：便当的精髓	龙X虎OVA便当的极意	龙虎斗OVA便当的精髓
芭比与魔幻飞马之旅	芭比娃娃与飞马魔法
飞出个未来大电影4：绿色狂想	飞出个未来：绿色狂想	TheFuturamaMovie4
牧笛	MuDi	BuffaloBoyandtheFlute
浜虎	滨虎	横浜之虎
遥远的世界	遥远世界	OtherWorlds
蔷薇少女梦见	RozenMaidenTraumend	薔薇少女第二季
当女孩遇到熊OVA2：夏、冲击性出道
美人鱼之海盗来袭	美人鱼公主之海盗来袭	TheLittleMermaid:AttackofThePirates
飞哥与小佛：星球大战	飞哥与发仔：星球大战
霹雳剑踪
不可告人的秘密	LessonXX不可告人的秘密
精灵守护者	精灵守护者	SeireinoMoribito
重装武器	HeavyObject
机动战士高达UCRE:0096	机动战士高达UCTV新编集版
宠物小精灵超梦～通往觉醒的序章～	神奇宝贝特别篇
黑与白	Blekenduait
坏机器人	小帮手	邪恶机器人
天降之物F	天降之物第二季
猫和老鼠：间谍使命	猫和老鼠：搜寻间谍
女武神驱动	VALKYRIEDRIVE-MERMAID-
地铁站的变态人格	地铁惊魂
疯狂侏罗纪	重返侏罗纪
拽妹黛薇儿要上大学了没	IsItCollegeYet	Daria:IsItCollegeYet-AnMTVMovie
天使怪盗
青之花	青之花
昭和元禄落语心中助六再临篇	昭和元禄落语心中第二季
机器人9号短片
宇宙奇趣录	重金属	宇宙神怪录
狐妖小红娘剧场版：下沙	千年御水珠总集篇
名侦探柯南OVA5：目标是小五郎少年侦探团的秘密调查
名侦探柯南OVA6：追踪失踪的钻石，柯南、平次VS基德	名侦探柯南OVA6-追踪失踪的钻石柯南、平次vs基德
名侦探柯南OVA8：女子高中生侦探铃木园子的事件簿
变态王子与不笑猫
新版猫和老鼠	新版猫和老鼠
战斗司书	TheBookofBantorra
宝贝女儿好妈妈
危险调查员	专家基顿	MasterKeaton
锁锁美同学@提不起劲	Sasamisan@Gambaranai	锁锁美小姐@不好好努力
绯弹的亚莉亚	HidannoAria	AriatheScarletAmmo
潘朵拉之心	PandoraHearts	潘多拉之心
甜美的老鼠生活	甜美的老鼠生活
浪漫小夜曲	浪漫小夜曲
蜡笔小新之爆发温泉火热大决战	蜡笔小新电影版第七部	爆发温泉火热大决战
平方根：海绵宝宝的故事
拖线狂想曲第二季	汽车闯天关：拖线狂想曲	汽车总动员：大话板牙
剧场版机动战士高达00先驱者的醒觉	MobileSuitGundam00Film-AwakeningoftheTrailblazer-
狐狸分饼
麦兜与麦唛	麥嘜故事	麦唛故事
不和谐音
宠物宝贝环游记	宠物老友记	宠物宝贝环游世界
驯龙宝典	驯龙高手短片：龙之书
死神剧场版：无人的回忆	Bleach剧场版别处的记忆	Bleach剧场版无人的记忆
名侦探波洛和马普尔小姐	阿加莎·克里斯蒂的名侦探波罗和马普尔夫人	AgathaChristie'sGreatDetectives
拖延症	拖延症
禽兽超人之无奸不摧
革命机Valvrave第二季
月球人	月亮先生	月亮上的人
史莱克在沼泽卡拉OK舞会
泡芙小姐的金鱼缸	Thebrighteleven-MissPuff'sGoldfishBowl
我的脑内恋碍选项	我的脑内选项正在全力妨碍学园恋爱喜剧
无限之住人	BladeoftheImmortal	无限之住人
接吻指南	接吻指南
哆啦A梦：大雄和发条都市	大雄的钥匙城历险记	大雄的发条都市冒险记
梦幻西游之天命之路	梦幻西游2：天命之路
火宵之月	KashonoTsuki
猫猫日本史
大耳朵图图第二季	大耳朵图图第二部
草莓棉花糖OVA2卷	IchigoMashimaroOVA2	草莓棉花糖OVA2卷
草莓棉花糖OVA3卷	IchigoMashimaruOVA3	草莓棉花糖OVA3卷
水星领航员TheAVVENIRE
超神学院	啦啦啦德玛西亚第四季
天使的水果糖
老夫子	OlderMasterQ
悟空大战二郎神
鸡妈鸭仔	走出院子的母鸡	叶芽，走出院子的母鸡
独木桥
猫和老鼠之巨人大冒险
米菲和它的朋友们
三国志	东映三国志
幻想嘉年华第二季	CarnivalPhantasm2ndSeason	カーニバル・ファンタズム音声付風雲イリヤ城
X战记	X战记
容易的生活	NeverCompromise
我自己；你自己	マイセルフ;ユアセルフ
西部意大利面
恶搞之家第十季	恶搞之家
名侦探柯南OVA2：16人的嫌疑犯	名侦探柯南OVA2:16人的嫌疑犯
元气囝仔小剧场	元气囝仔ONA	Mijikamon
皮皮鲁和鲁西西	罐头小人
你并不孤独
六十六	陸拾陸
端脑
幻影集	AFantasy	幻影集
川之光	川之光
桑杰的超级战队	桑杰的超级团队	桑杰的超人特工队
法式炒咖啡	法式烘焙咖啡	法国烧烤
青葱岁月	珍贵日子的梦想	初恋于青葱岁月
巴赫狂想曲	巴哈狂想曲	巴赫狂想曲
亡国的阿基德最终章：致我所爱	CodeGeass亡国的阿基德最终章致我所爱
小猪威比
六人患病	六人患病
鲁邦三世：鲁邦VS复制人	RupansanseiMamokaranochousen	Lupinthe3rd:TheMovie-TheSecretofMamo
零之使魔2～双月的骑士～	零之使魔2～双月的骑士～	零之使魔第二季
月朗星稀夜	月朗星稀夜
鸡皮疙瘩	怪物游戏	书中自有魔怪谷
游戏王十周年纪念剧场版超融合超越时空的牵绊	GekijoubanYuugiou:ChouyuugouJikuuokoetakizuna	游戏王剧场版:超融合穿越时空
唱K小鱼仙第二季	真珠美人鱼第二季	人鱼之心第二季
银河铁道之夜	Ginga-tetsudonoyoru	NightontheGalacticRailroad
美丽的森林	BeautifulForests
砰砰杰瑞德	砰砰杰瑞德
水脑袋	脑子进水了	脑袋进水
甜甜私房猫2	起司猫2	Chi'sNewAddressチーズスイートホーム
南家三姐妹第四季	みなみけ4期
暴力宇宙海贼	宇宙海盗	暴力宇宙海贼
但丁的地狱之旅	但丁的地狱之旅
亡命鸡礼花
天降之物剧场版：永远的我的鸟笼
叮当猫	Pokonyan
金箍棒传奇	夺宝幸运星大电影之金箍棒传奇	开心西游记
小魔女DoReMi	小魔女DoReMi
复仇者集结第二季
日常の0話	NichijouOAD	日常の0話
虐杀器官	GenocidalOrgan
脏男孩的世界	脏男孩的世界
丁丁历险记2：太阳的囚徒	太阳的囚徒	丁丁历险记2：太阳的囚徒
兔龟高校网球部
战神金刚
正义联盟：新的边际	超人联盟之惑星新战线
赛文奥特曼	奥特赛文	咸蛋超人七号
漫画家与助手们	Mangaka-santoAssistantsanto
象之背
阿凡提的故事之奇婚记	第十二集：奇婚记
秀逗魔导士EVOLUTION-R	魔剑美神EVOLUTION-R	秀逗魔导士EVOLUTION-R
爱迪奥特曼	艾迪奥特曼	我的囧老师是奥特曼
海贼王梅利篇：另一名同伴的故事	海贼王梅利篇：另一名伙伴的故事	海贼王特别篇前进梅利号
魔术快斗	怪盗基德	神偷怪盗
灰尘家族
逮捕令OVA	You'reUnderArrest	Taihoshichauzo
战国BASARA2	戦国BASARA贰	战国BASARA2
养家的人
一千零一夜	Senyaichiyamonogatari	OneThousandandOneNights
时光旅行
超兽武装之勇者无惧	超兽武装第二部
灰与幻想的格林姆迦尔OVA
玉响第一季	幸福光斑
更黄更暴力	更黄更暴力
妖精的尾巴剧场版：凤凰的巫女	凤凰的巫女	劇場版フェアリーテイル鳳凰の巫女
格林名著剧场	Gurimumeisakugekijou	GrimmMasterpieceTheatre
军火女王
苍穹之法芙娜	苍穹之战神	SoukyuunoFafner
翠星之加尔刚蒂亚OVA：稀人的祭坛	翠星之加尔刚蒂亚第15话
超级飞侠第一季
日常工作第六季	天兵公园	日常参考
新机动战记高达W	新機動戦記ガンダムＷ	新机动战记W
神勇战士第一季	无畏战士
死亡空间：坍塌	DeadSpaceDownfall	死亡空间：坍塌
芭比之时尚童话	芭比之时尚奇迹	Barbie-ModezauberinParis
乱马1	RanmaNibunnoIchi	Ranma1
自然上色
机器人嘉年华	机器人的嘉年华会	机器人狂欢节
幻想嘉年华第三季	CarnivalPhantasm3rdSeason
喜羊羊与灰太狼之羊羊运动会	喜羊羊与灰太狼(第531-590集)
机动战士高达第08MS小队	機動戦士ガンダム第08MS小隊	机动战士高达第08MS小队
圣哥传OAD
神奇宝贝剧场版：破坏之茧与蒂安希	宠物小精灵XY剧场版：破坏之茧	PokémontheMovie:DiancieandtheCocoonofDestru
忍者神龟2	忍者龟2	忍者神龟2
西蒙和他的猫	西蒙的淘氣貓:餓貓耍主人	西蒙的猫
哈瓦那的吸血鬼	VampiresinHavana	哈瓦那的吸血鬼
读或死	死亡的思考	读或死
拉斯卡尔
东北花泽类之起幺蛾子
摇滚新乐团	Beck:MongolianChopSquad
学院变体立达	学院变体立达
彩云国物语第2季	SaiunkokuⅡ	SaiunkokuMonogatari2
名侦探柯南特典：9号半之花	名侦探柯南M16特典：幻想曲之花	名侦探柯南M16特典：9号半之花
怪诞小镇特别篇：松林之间
久石让在武道馆：与宫崎骏动画一同走过的25年	久石让在武道馆：与宫崎骏动画一同走过的25年
黑暗正义联盟	DarkUniverse
生命之门	精神病患者的美丽心灵世界
科学小怪蛋	伊戈尔	异想天开
银魂真人版
火影忍者疾风传剧场版：失落之塔	剧场版火影忍者疾风传失落之塔	NARUTO疾风传剧场版7
孔明的陷阱	孔明の罠
滑头鬼之孙奴良组事始	ー奴良組事始ー
磁带女孩	CassetteGirl	日本アニメ見本市第35話
大雄兔	肥兔子邦尼	大雄兔
那年那兔那些事第三季
礼拜天	星期天	Sunday
捷克惊魂夜	怪诞城妖夜	OneNightinCity
魔笛奇遇记	魔笛
天眼小神童
水果宝贝之水果总动员	FruitStory
森林大帝	Shinsakujungletaitei	JungleEmperor
无头骑士异闻录：天网恢恢	无头骑士异闻录TV未放送第12.5话	Durarara:Heaven'sVengeance
代用品	Ersatz
少年犯之七人	少年犯之七人	二舍六房的七人
我家也有外星人	ニアアンダーセブン	我家也有外星人
天国少女	天国少女
爱的迷幻	Love&Theft
海贼王TV版路飞特别篇	海贼王SP22：手之岛的冒险	海贼王Z放映纪念特别篇：路飞手掌岛的冒险
神秘的女蝙蝠侠	蝙蝠侠：神秘的蝙蝠女	神秘的女蝙蝠侠
天元突破剧场版：红莲篇	天元突破红莲之眼剧场版：红莲篇	天元突破红莲螺岩剧场版红莲篇
连升三级	张别古当官
千子2	Cencoroll2
乐高好朋友：四姐妹的幸福生活
为美好的世界献上祝福OAD
百花缭乱武士少女	百花缭乱SamuraiGirls
氰化欢乐秀第一季	快乐氰化物
超级科学伙伴	超级科学战队
蜡笔小新之电击猪之蹄大作战	蜡笔小新电影版第六部	电击猪之蹄大作战
吹响悠风号2	奏响吧上低音号2
钢索危情OVA2	tightrope	钢索危情
太空嬉哈族
幻想嘉年华	TAKEMOON	CarnivalPhantasm
飞天小女警第二季
丑小鸭历险记	TheAdventuresoftheUglyDuckling
麦布里奇的线	迈布里奇的最终梦想	麥布里奇之弦
HEARTWORK〜SymphonyofDestruction〜	HEARTWORK	ハートワーク
小昆汀
四驱兄弟WGP暴走四驱大追踪
宠物小精灵：雪拉比的超越时空遭遇	口袋妖怪剧场版第四弹	Pokemon4ever:Bestfriends,Betterheroes
阿凡提的故事之巧断案	第七集：巧断案
老鼠嫁女
鸟之歌	TorinoUta
恋爱舞台
米老鼠2013第一季	米奇欢乐多
漫威超级英雄大冒险之冰霜大作战	漫威超级英雄大战冰霜王
美少女战士SS特别篇	SailorMoonSuperSSpecial
贝贝生活日记
梅宝的剪贴簿第五季	怪诞小镇迷你剧第五季
排球少年剧场版：结束与开始
排球少年OAD	排球OAD
游戏王5D's	游戏王5D's	YUGIHO5D's
pupa	ピューパ
机动警察	机动警察	MobilePolicePatlabor
记录的地平线第二季	LogHorizonSeason2
命运之夜无限剑制SunnyDay	命运之夜UBW特典OVA
电锯女仆	超强电锯女仆	电锯妹抖
狐狸打猎人
圣斗士星矢：黄金魂	SaintSeiya:SoulofGold
五星物语	TheFiveStarStories
胡桃夹子：魔境冒险	胡桃夹子：未说的故事	胡桃夹子与鼠王
机动战士高达00	MobileSuitGundam00
小熊维尼:寻找克里斯多夫罗宾	小熊维尼:寻找克里斯多夫罗宾
校园迷糊大王二学期	SchoolRumble:SecondSemester
不管我怎么去想我不受欢迎这件事都是你们的错OAD	喪13
你好七叶第二季
鬼太郎	鬼太郎	gegegenokitaro
猫汤剧场	ぢるぢるORIGINAL	NekojiruGekijou
金田一少年事件簿R第二季	金田一少年事件簿2015
选美记
米芽米咕人	米娅和米高人	米娅和米高巨人
上海蝙蝠侠	TheBatManofShanghai
对学生会长的忠告OVA2	学生会长请注意OVA2	对学生会长的忠告OVA2
僵尸借贷	Zombie-Loan
龙珠Z剧场版：把我的悟饭还来	龙珠Z：死亡地带	龙珠Z：热血热斗
evangelion：AnotherImpact-MAKINGOF	日本动画展览会第20B话	日本アニメ見本市第20B話
宏蓝幻想	GranblueFantasy
罗宾汉	侠盗罗宾汉	罗宾汉
芭比之森林公主	芭比之森林公主
Anne-Happy	Unhappy
房东妹子青春期
骷髅舞	骨骼的舞蹈
破晓之时	破晓之时	当那一天到来的时候
千年女优：轨迹
恶搞之家第四季	搞怪一家人第四季	格利芬一家第四季
告白实行委员会：我于此刻恋上你
头文字D新剧场版：觉醒	NewInitialDtheMovieLegend1:Awakening
海绵宝宝第八季
时间大使莫莫
幽灵公主诞生物语
柳林风声	柳林风声
暗杀教室	AssassinationClassroom
我的碧可3	MyPico3
Cupidon	丘比特的大失误	丘比特
赌博默示录：破戒录篇	逆境无赖KAIJI第2季	逆境无赖开司破戒录篇
新哥斯拉
圣传：双城炎雷篇	圣传-双城炎雷篇
龙在哪里
佝偻猫第二季	未来猫第二季
白兔糖特典OVA	BunnyDropminiOVA	UsagiDropminiOVA
偶像大师	THEIDOLM@STER
学生会的一己之见	学生会的一存碧阳学园学生会议事录
莽荒纪	TheLegendofJadeSword
男子拉拉队	拉拉队男生	拉拉队男子
钢铁神兵	B'TX	B'TX鋼鐵神兵
大神与七位伙伴	大神与七位伙伴
人形电脑天使心	Chobits
泡泡之旅	苏比之旅	泡泡之旅
外部世界
银魂OAD：必杀技篇	GintamaOAD
斗神都市2	TournamentoftheGods:TitleMatch
日常工作第五季	天兵公园	日常参考
天使的心跳特别篇：通向天堂的阶梯
G-九
潜行吧奈亚子W	這いよれニャル子さん2期	袭来美少女邪神第二季
银发的阿基多	银发阿基德	银色头发的阿基德
中华勤学故事
听爸爸的话暖呼呼	听爸爸的话TV未放送第13话
钢铁侠与浩克：联合战记	钢铁侠与绿巨人：英雄集结	钢铁侠与绿巨人：联合战记
小小羊蒂米第二季	快乐小羊吉米
百合星人奈绪子	YuriSeijinNaoko-san	百合星人奈绪子美眉
海贼王特别篇23：绝妙孤岛	海贼王特别篇23：GloriousIsland	海贼王SP23：GloriousIsland
BB保你大	BB保你大
捉龙特攻队	屠龙猎手
杯子里的小牛	MyMilkCupCow
猪猡之王	一辈子猪猡	猪王
迷糊餐厅第二季	ワーキング2期	WORKING2
侦探学园Q	侦探学园Q	侦探学院Q
俄罗斯之魅：苏联时代的俄国动画	MagiaRussica
小凉宫春日的忧郁	SuzumiyaHaruhichannoyûutsu
功夫熊猫感恩节特辑	功夫熊猫：冬至特辑
超兽武装之仁者无敌	UltraBeastForce
银魂春祭2010（假）	银魂春祭
寒蝉鸣泣之时·礼	秋蝉鸣泣之时·礼	寒蝉鸣泣之时OVA
哆啦A梦：大雄的人鱼大海战	DoraemontheMovie:Nobita'sMermaidLegend
机巧少女不会受伤	UnbreakableMachine-Doll
德克斯特的实验室第二季	Dexter'sLabSeason2	DexterdeShiyanshiSeason2
动物也疯狂	德里历险记	德里动物园
魔法少女伊莉雅第一季	Fate	kaleidliner魔法少女☆伊莉雅	Fate	kaleidlinerPrisma☆Illya
星舰驾驶员	星舰驾驶员	宇宙战舰战士
猥琐传说：大电影
伟大的历史动画	Grasshoppers
鲁邦三世新系列	LupinIII-L'avventuraitaliana	鲁邦三世意大利的冒险
纯情房东俏房客	LoveHina
昭和物语	ShowaMonogatari
莫迪斯
我的朋友很少第二季	我的后宫很多
闪灵二人组	GetBackers	闪灵夺还屋
疾走王子	疾走王子Alternative	PrinceofSTRIDE
世纪末救世主传说北斗神拳
芝麻街第一季	芝麻街	OpenSesame
最近，妹妹的样子有点怪OVA
新番哆啦A梦	哆啦A梦	新哆啦A梦
氰化欢乐秀第二季
刺猬背西瓜
狐狸送葡萄
小蛋壳
枪神剧场版	TRIGUNBadlandsRumble
魔兽世界：战争之王
吹笛子的男人	ThePiedPiper	ThePiedPiperofHamelin
元气少女缘结神OVA：神明，被丢弃	神明，去泡温泉	KamisamaHajimemashita
意乱情迷我们的不归路	意乱情迷～我们的不归路
辛普森一家第十一季	阿森一家第十一季	辛普森一家（第十一季）
超人：解放	超人：挣脱束缚
超梦我就在这里	超梦归来
电梯一日	上上下下	OneDayInlift
境界的彼方剧场版过去篇	BeyondtheBoundarytheMovieI'llBeHere:ThePast	GekijoubanKyokainoKanataI'llBeHere:
芭比公主之钻石城堡	BarbieandtheDiamondCastle
妄想学生会OAD4	妄想学生会第18话
火星异种OVABUGS2号篇	TerraFormarsOVA
鬼灯的冷彻OAD2	HoozukinoReitetsuOAD
梦想夏乡	梦想夏乡
美国队长3	美国队长3：内战	美国队长3：英雄内战
辛普森一家：家庭治疗	辛普森一家：家庭治疗
名侦探柯南特典：新泻·东京礼物狂想曲	名侦探柯南M15特典
衣食住行	物质享受	住的舒服吗
阳光中的青时雨
长江7号爱地球	长江七号爱地球	长江7号：动画版
神奇宝贝：皮卡丘的暑假	宠物小精灵之比卡超的假期	Pikachu'sSummerVacation
神探加吉特	G型神探	数码特工
妄想学生会OAD	妄想学生会第14话
地下室的怪物	去地牢	DowntotheCellar
现视研	Genshiken
塞巴斯蒂安的巫毒	塞巴斯蒂安的巫毒
黑之栖CHRONUS	黒の栖CHRONUS	KuronoSumika-Chronus-
不思议游戏	魔幻游戏	不可思议的游戏
妄想学生会OAD3	妄想学生会第17话	SeitokaiYakuinDomo
阿凡提的故事之兔送信	第二集：兔子送信
贪吃树	树婴	吃人滴滴仔
遗迹守护者	保卫者	世界未日
浮游泉大冒险
恶魔幸存者2	デビルサバイバー2	DEVILSURVIVOR2theANIMATION
毁结局系列第一季	HISHE
摄影师的复仇	TheCameraman'sRevenge	TheRevengeofaKinematographCameraman
小长门有希的消失OAD	长门有希酱的消失OAD	TheDisappearanceofNagatoYuki-chanOAD
偶像大师灰姑娘女孩	THEiDOLM@STER:CinderellaGirls
丽莎和她的朋友们第一季	丽莎和她的朋友们
小羊肖恩第二季	超级无敌羊咩咩第二季	笑笑羊第二季
大白鲸	TheWhiteWhaleOfMu
小忍者
森林王子2	森林王子2	小泰山2动物嘉年华
尽管如此世界依然美丽	SoredemoSekaiwaUtsukushii	Stillworldisbeautiful
东方神娃	东方神娃第1部
甜蜜的家	被解雇的猫	甜蜜的家
闪光的夜袭	闪光的夜袭
问题儿童都来自异世界	ProblemChildrenAreComingfromAnotherWorld,Aren'tThey	Mondaiji-tachigaisekaikarakur
南家三姐妹久候多时	南家三姐妹OAD2
忍者神龟第一季	新忍者神龟
天使的心跳特别篇：地狱厨房
小羊肖恩第三季	超级无敌羊咩咩第三季	笑笑羊第三季
堀桑与宫村君OVA3	堀与宫村OVA3	HORI-sanToMIYAMURA-kunOVA3
汽船威利	汽船威利
3月的狮子	三月的狮子动画版
猫和老鼠：迷失之龙	TomandJerry&TheLostDragon
校长与鲸	ManandWhale
齐天大圣前传	齐天大圣－前传	PrequeloftheMonkeyKing
眉间尺
跟班×服务	爆趣乡公所	公仆×服务
特别车队
神奇宝贝AG	神奇宝贝超世代	ポケットモンスターアドバンスジェネレーション
哆啦A梦：大雄的宇宙小战争	Doraemon:Nobitanouchuushô-sensô
特别快递	特别快递	Livraisonspéciale
辛普森一家第二季	TheSimpsons	辛普森一家第二季
海贼王剧场版3：珍兽岛的乔巴王国	海贼王剧场版：珍兽岛的乔巴王国
阿德曼动画精选：超级无敌掌门狗	酷狗宝贝	超级无敌掌门狗
血咒圣痕	血咒圣痕OVA	ヴァッサロードOVA
向阳素描x365OVA	HidamariSketchx365OVA
史前之旅	JourneytoPrehistory	史前之旅
小鸟派	小鸟派
贤治之春	春与修罗	IhatovGensou:KenjinoHaru
爱心熊	小熊威克	爱心熊
新我们这一家
黏黏糊糊角质君	角栓君
孙悟空大冒险	悟空の大冒険	孙悟空的大冒险
请问您今天要来点兔子吗第二季	IsTheOrderARabbit
阿笨猫
无敌破坏王2
圣斗士星矢冥王哈迪斯冥界篇后章	SaintSeiya:TheHadesChapter-Inferno	圣斗士星矢:冥界篇
BamanPidermanSeason1
STRANGE+	StrangePlus
小肥肥一族	小肥肥一族
中国惊奇先生2015
双子星公主	不可思议星球的双胞胎公主	不思议双子星公主
择天记第二季
快要坏掉的八音盒	破碎边缘的八音盒	Half-brokenMusicBox
日常工作：电影版	日常工作大电影	天兵公园：电影版
玻璃之花与坏掉的世界	Garakowa-RestoretheWorld	VitreousFlower&DestroytheWorld
已知的宇宙	DigitalUniverse
阿甘妙世界第二季
可怜的比埃洛	PoorPierrot
印度神明	奎师那	HeyKrishna
芭比之圣诞颂歌	芭比之圣诞颂歌
人小鬼大	亞倫·基哥利
渥大利亚	DôwameitasenshiWindaria	Windaria
真魔神英雄传魔神山篇
疾暴执行部OVA：航
红莲第二幕暗	红莲第二幕暗
SexandViolencewithMachSpeed	日本アニメ見本市第14話	日本动画展览会第14话
境界的彼方偶像裁判～即使迷茫也要裁决之人～	境界的彼方web配信短篇动画
自深渊中	FromtheSea
WhatSheWants
妄想学生会新OVA2	妄想学生会第20话	生徒会役員共帰ってきたOVA2
逮捕令全速前进	逮捕令第三季
大叔与棉花糖OVA	棉花糖大叔ova
命运之夜原型	命运原型	命运之夜原型
吃饭睡觉打豆豆	Eat,Sleep,PummelDodo
战勇OVA：学园战勇，青春物语	战勇OVA04
雌狐第一季
KY系JC小空气
波波安第一季	Disney'sPepperAnn	波波安
高智能方程式赛车	新世纪GPX高智能方程式赛车	FutureGPXCyberFormula
下士小黑	NorakuroGocho	CorporalNorakuro
复活森林	精灵森林	老鼠总动员
飙速宅男OAD	弱虫脚踏板OAD	飙速宅男SPECIALRIDE
幸福是一条温暖的毛毯	Aboldogságegymelegtakaró,CharlieBrown
老虎学艺
山口山战记之草裙娃娃	我叫MT第七季先导季
太阳王子霍尔斯的大冒险	PrinceoftheSun	太阳王子霍尔斯的大冒险
小战象	大象将军	KhanKluay
网球并不可笑嘛第二季	女高网球部第二季
如斯星球
皮皮的故事
宠物小精灵：护林员与沧海之王子玛娜霏	口袋妖怪2006年剧场版	苍海的王子
马小乐之玩具也疯狂	MaXiaoleandHisToys
富士见二丁目交响乐团：寒冷前线的指挥官	FujimiBlockNo.2SymphonyOrchestra	富士见交响乐团
鼹鼠的梦
大魔神对盖塔机器人
梦游的杰瑞	梦游的杰瑞
龙之纪元：追索者的黎明	龙腾世纪-血魔圣战-	ドラゴンエイジ-ブラッドメイジの聖戦-
乱马1	2：中国昆仑大决战破坏计划之激斗篇	乱马1	2：中国昆仑大决战破坏计划之激斗篇
蔷薇少女～序曲～	薔薇乙女OVERTRUE	薔薇少女OVERTRUE
攻壳机动队：崛起3
冰雪女王2	冰雪皇后2	Snezhnayakoroleva2.Snezhnyykorol
临死江古田酱	临死江古田酱
少年桑塔的大冒险	天生礼物狂	TheLifeandAdventuresofSantaClaus
评论家	评论家
宇宙英雄之超银河传说	超人大怪兽格斗之超银河传说	宇宙英雄奥特曼之超银河传说
暗夜魔法使	NightWizard
四驱兄弟III	四驱兄弟III
权力的游戏第六季	冰与火之歌：权力的游戏第六季	王座游戏第六季
湾岸午夜	灣岸競速湾岸竞速
阴守忍者	偷偷的守护你
神明之胄
现实之舞	童年幻舞	舞蹈现实
芝加哥烈焰第四季	风城烈火
哨声响起	哨声响起
第一神拳NewChallenger	HajimenoIppo:NewChallenger
中华传统美德故事
丛林里的故事	狼孩莫格里	Mondo'sJungleBook
真·女神转生东京默示录	ShinMegamiTenseiTokyoRevelation	真·女神转生东京默示录
潜行吧奈亚子F	袭来美少女邪神F
摇滚舞会	摇滚舞会
语词，语词，语词	Words,Words,Words
樱桃小丸子动画25周年纪念特别篇携手同游~苦乐交织的美味特辑	樱桃小丸子
奎斯特历险记第一季	奎斯特的世界	乔尼大冒险
皇帝的睡眠
沙丘城堡	居者有其屋
金田一少年之事件簿SP3：吸血鬼传说杀人事件	金田一少年之事件簿特别篇3：吸血鬼传说杀人事件	金田一少年之事件
乃木坂春香的秘密	NogizakaHarukanoHimitsu	乃木坂春香的秘密
正义联盟行动
哈姆太郎第四季
E.T.外星人	外星人E.T.	外星人
驯龙记：飞越边界第三季
加菲猫的万圣节冒险	GarfieldinDisguise	加菲猫的万圣节冒险
第九区	第九禁区	D-9异形禁区
小猫钓鱼
塞尔柯克漂流记	塞柯克漂流记	Selkirk:ElverdaderoRobinsonCrusoe
网球并不可笑嘛第三季	女高网球部第三季
六神合体	雷霆王
世纪末DARLING
寻找家园	寻找新居	寻找栖所
神奇山谷	MagicValley
八犬传：东方八犬异闻第二季
魔女的考验	魔界女王候补生	SugarSugarRun
勇者警察
至高指令OAD
汤姆的能量	汤姆的能量
落语天女唯	落语天女唯	Rakugotennyooyui
新大头儿子和小头爸爸第一季	新大头儿子和小头爸爸1
南飞的鸭子
小红帽恰恰	RedHoodChacha
捉鬼特工队	驱魔人
魔法禁书目录剧场版恩底弥翁的奇迹
我是汤姆·穆迪	我是闷闷不乐的汤姆
妖怪手表：诞生的秘密喵	电影版妖怪手表：诞生的秘密喵	Yo-kaiWatchtheMovie
开心汉堡店第一季	欢乐汉堡店	阿三汉堡王
故事少女穗乃果	故事少女穗乃花
圣诞颂歌	圣诞颂歌
头文字D最终季	头文字D第六季
天元突破剧场版：螺岩篇	天元突破剧场版第二弹	天元突破红莲螺岩剧场版
全裸投球手铁雄
第一小队	幽灵特工	FirstSquad:TheMomentofTruth
装鬼兵MD2	M.D.GeistII
黑之契约者外传	DarkerThanBlackGaidenOVA
寿司警察	スシポリス
超魔神英雄传	魔神英雄传3
TIGER&BUNNY特别版SIDETIGER
格林童话和故事系列	格林童话和故事系列
沉睡魔咒	黑魔后：沉睡魔咒	黑魔女：沉睡魔咒
忏·再见，绝望先生	忏・再见，绝望先生
机动警察初期OVA版	机动警察OVA1	MobilePolicePatlaborOVA1
帝都物语	DoomedMegalopolis
HornDog
乌冬面之国的金色毛毬
大空魔龙	大空魔龙
坚定的锡兵	TheSteadfastTinSoldier
哈可布·赫夫那坦杨	HagopHovnatanian
无头男人	没有头的男人	TheManWithoutaHead
魔法少女奈叶StrikerS	MagicalGirlLyricalNanohaStrikerS	魔法少女奈叶StrikerS
机动警察后期OVA版	机动警察OVA2	MobilePolicePatlaborOVA2
希望宅邸第二弹
天线宝宝：抱抱
疯狂兔宝贝
孤独还剩多久
残缺影像	TheMissingPicture
童话高中：春天凋零
老夫子2001	MasterQ2001
摩尔庄园冰世纪	LegendofTheMoles-TheFrozenHorror
白色猎人第二季	WeißKreuzGlühen	白色猎人第二季
宇宙小子第二季	宇宙仔斯蒂文
小长门有希的消失	长门有希酱的消失
花牌情缘OAD	花牌情缘只有在这里才能看到的甜酸学园故事
正义联盟：银河守护者第一季
阿长与山海经
百合星人奈绪子OVA
乐高星球大战：新尤达编年史之全息记录仪竞速
球形精灵的兴衰
未定名韦斯·安德森定格动画电影
乐高星球大战：尤达编年史之西斯的威胁
一日美好	求爱五百里
假面骑士空我	MaskedRiderKuuga	幪面超人Kuuga
我们大家的河合庄小剧场	我们大家的河合庄SP
辛普森一家第二十季	阿森一族	辛普森一家
仙乐传说：希尔瓦兰特篇	TalesofSymphonia	仙乐传说动画版
心灵之窗
希望宅邸TV版
火影忍者剧场版：炎之中忍试验鸣人VS木叶丸	火影忍者短篇剧场版：炎之中忍试验鸣人VS木叶丸	火影忍者疾风
花丸幼稚园	花圈圈幼稚園
我的脑内恋碍选项OVA	のうコメ
异度传说THEANIMATION	XenosagaTHEANIMATION	异域传说THEANIMATION
春天来了
懦弱鬼harry	Sci-FiHARRY	懦弱鬼哈利
史酷比格斗狂热迷	Scooby-DooWrestleManiaMystery
鲁邦三世：俄罗斯之恋	LupinIII:FromRussiawithLove	鲁邦三世：俄罗斯之恋
被嫌弃的松子的一生	花样奇缘	令人讨厌的松子的一生
玉响第二季	玉响第2期	玉响：勇往直前
整容室第一季	整形春秋第一季
守护月天（TV版）	守护女神月天	denshinmamotteshugogetten
秀逗魔导士NEXT	SlayersNext	秀逗魔导士NEXT
亚当斯一家的价值观	阿达一族	爱登士家庭2
新少年黄飞鸿
一骑当千龙之命运	Ikkitousen:DragonDestiny
狡猾飞天德第一季
2014奥斯卡动画短片提名合集	TheOscarNominatedShortFilms2014:Animation
乐高星球大战：新尤达编年史之逃离绝地圣殿
希望宅邸TV版第二季
一颗千变万化的行星	一个千变万化的行星	PhantasMagoria
未来狂想曲	未来狂想曲
小狗波图	雪地灵犬	雪橇犬巴尔图
小美人鱼	小美人鱼真人版
汤姆与杰瑞遇见福尔摩斯	猫和老鼠与福尔摩斯	汤姆与杰瑞遇见福尔摩斯
泡芙小姐花漾季
异乘记	TrainofThrought
TheConservatory
思念的碎片	OmoinoKakera
母鸡搬家
梦滨城	月光都市	懵逼城市
范海辛：伦敦任务	范海辛：伦敦任务
三国志：辽阔的大地	三国志第三部
白色相簿2	WhiteAlbum2
变形金刚2	变形金刚2：堕落者的复仇	变形金刚狂派再起
兰花花	Lanhuahua
LIMITCYCLE
樱花大战	樱大战	サクラ大戦
回首再见她	Bobby`sGirl	ボビーに首ったけ
网球并不可笑嘛第五季	女子搞笑网球第五季	女高网球部第五季
八里沟
新机动战记高达W无尽的华尔兹特别篇	高达W：无尽的华尔兹剧场版	NewMobileReportGundamWing:EndlessWaltz
永夜球场
小小士兵	TheLittleSoldier
哆啦A梦：大雄的恐龙	Doraemon:Nobitanokyôryû	Doraemon:Nobita'sDinosaur
吃鸟瘾	鸟的烦恼	吃鸟瘾
希望宅邸	Yurumeitsu
剧场版战国BASARA-TheLastParty-	战国BASARA剧场版	剧场版战国BASARA-TheLastParty-
创圣大天使	创圣机械天使	创圣的亚库艾里翁
未确认进行式	EngagedtotheUnidentified	MikakunindeShinkoukei
神勇战士第二季	无畏战士
双恋Alternative	FutakoiAlternative	双恋Alternative
无敌雷诺
妖狐×仆SSTV未放送第13话	妖狐×仆SS特别篇
苍之瞳的少女	TheThirdAoihitominoshyoujyo
头消失了	TheHeadVanishes
辛普森一家之恐怖树屋第十六部	"TheSimpsons"TreehouseofHorrorXVI	辛普森一家之恐怖树屋第十六部
陆奥圆明流外传修罗之刻	陸奥圓明流外伝修羅の刻
精灵鼠小弟3	精灵鼠小弟3	一家之鼠3
梅宝的生活指南第二季	怪诞小镇迷你剧第二季
电视短片第四季	怪诞小镇迷你剧第四季
石墙侠与暴动侠：终极高潮	石墙侠与暴动侠：终极高潮
变态	Hentai
欢乐树的朋友们：第二发球	快乐森林2：第二发球	快乐森林短片合集
赛尔号大电影5：雷神崛起	赛尔号5	SeerMovie5:RiseofThunder
船上的芭蕾女伶	船上的芭蕾女伶	BallerinaontheBoat
歌之王子殿下真爱革命	歌之王子殿下第三季
狐狸与猎狗2：永远的朋友	狐狸与猎狗2
芭比之奇幻日记	芭比之公主日记
帝都物语
恶魔之谜	恶魔谜题	恶魔的谜语
Superman75	超人75周年纪念短片
森林传说	Morinodensetsu	LegendoftheForest
福尔摩斯二世	小私家侦探
灵魂摆渡2	灵魂摆渡第二季
木乃伊	神鬼传奇	盗墓迷城
神圣之门	DivineGate
生死线	战地三部曲	战地1938
悠久之翼总集篇	悠久之翼剧场版
只要你说你爱我OAD
温泉物语OAD	温泉巡礼
龙珠Z剧场版8：燃烧吧热战·烈战·超激战	龙珠Z：燃烧吧热战	DragonBallZ-Broly-TheLegendarySuperSaiyan
四叶游戏	四葉游戲	CROSSGAME
女仆咖啡厅	即使如此小镇还是转个不停	即使如此小镇依然转动
选择破坏者WIXOSS
信长的忍者
刺猬索尼克第一季	刺猬索尼克
阿拉丁第一季
惩恶扬善白领侠	打击罪恶撒拉力曼曼	惩恶扬善白领侠
人鱼之伤	Mermaid'sScar
石头的游戏	AGamewithStones	石头的游戏
守护之灵
偷影子的老鼠
瘪四与大头蛋	弱智与丧门星玩转美国	黐孖B
超级英雄的一天第一季
妖精的尾巴：回忆之日	メモリーデイズ
紫罗兰永恒花园	VioletEvergarden
我们这一家剧场版	我们这一家剧场版
美男高校地球防卫部LOVE	美少男战士	男版美少女战士
魔比斯环	魔比斯环3D	魔必尔斯环
云州大儒侠史艳文	大儒侠史艳文	云州大儒侠
机动战士Z高达：星之继承者	MobileSuitZGundam:ANewTranslation-HeirstotheStars
盗墓笔记	TimeRaiders	TheLostTomb
降魔成道
若叶女孩	百合女孩	Wakaba*Girl
史酷比和WWE的恶魔诅咒
七色花
滚蛋吧肿瘤君	消失吧肿瘤君	消失吧，肿瘤君
吸血鬼猎人D
对某飞行员的追忆	对某个飞行员的追忆	Toaruhikoushienotsuioku
零之使魔三美姫的轮舞	零之使魔三美姫的轮舞	零之使魔第三季
彼得兔	比得兔
我叫MT第六季
恋爱货币
不思议游戏OVA3：永光传	魔幻游戏OVA3永光传
辛普森一家：托儿所的漫长日	辛普森一家：漫长的日护	托儿所的漫长日
三傻大闹宝莱坞	三个傻瓜	作死不离3兄弟
狼来了	疑神疑鬼的小猪
向阳素描沙英·寻毕业篇OVA
忍者杀手SE版
邮递员派特叔叔	邮递员派克叔叔	PostmanPatandHisBlackandWhiteCat
和平之旗	希望之旗
查理布朗男孩	小英雄擂台斗智
我们的朋友熊小米
stanley
神枪少女	神枪少女
中二病也要谈恋爱恋OVA	中二病也要谈恋爱恋TV未放送第13话	中二病也要谈恋爱第二季第13
地球卫士	魔锤变变变
圣诞大赢家	TheWinner
白砂糖战士	SugarSoldier
桑德坎
魔幻美少女	魔幻美少女
星蝶公主第二季
杀手阿一（动画版）	杀手阿一（动画版）	Koroshiyaichi:TheAnimationEpisode0
初恋这首情歌	初恋无限JAM	摇滚青春恋习曲
变态生理研讨会	HenZemi
羊之歌	羊之歌	羔羊之歌
宝贝熊-玩笑王国
极道鲜师	Gokusen	极道鲜师
在盛夏等待	AnoNatsudeMatteru
妙先生之雨的孩子	妙先生-雨的孩子	RainKids
12岁：小小胸口的怦然心动
大耳猴啊啦啦	大耳猴
学走路	LearningtoWalk	ŠKOLAHODANJA
芭比Girl	芭比Girl
我的女神第二季缤纷之翼	我的女神第二季缤纷之翼
零之使魔～三美姬的轮舞充满诱惑的海滩	零之使魔～三美姬的轮舞OVA	零之使魔～三美姬的轮舞充满诱惑的海滩
超智能足球GGO	超智能足球GGO
辛普森一家第十九季	辛普森一家	阿森一族
飙速宅男Re:RIDE	飙速宅男一期总集篇
亜人第3部衝戟
派特森与芬达猫3:圣诞奇遇
超元气三姐妹増量中	超元气三姐妹2期	超元气三姐妹増量中
BajiBaji
复仇者：世上最强英雄组合第二季	复仇者:世上最强英雄组合第二季
木偶奇遇记	匹诺曹	木偶奇遇记
小魔女DoReMi大合奏	OjamajoDoremiDokka~n	小魔女DoReMi4
时空的旅人	TokinoTabibito-TimeStranger-
意大利版狮子王	意大利版狮子王
星球大战：义军崛起第一季	星球大战：反抗军起义	星球大战：反叛军
境界之轮回第二季	KyoukainoRinne
麻辣教师	GREATTEACHERONIZUKA	麻辣教师
女皇之刃流浪的战士	QUEEN'SBLADE	女王之刃
大唐西游记
神奇宝贝：皮卡丘的冬季假期2001	Pikachu'sWinterVacation2001	宠物小精灵：比卡超的冬季假期2001
热血车城第一季
光之美少女	WearePrettyCure	美丽祭师二人组
金田一少年之事件簿剧场版1：歌剧院新杀人事件	新歌剧院杀人事件
棒球大联盟剧场版：友情的一球	剧场版棒球大联盟友情の一球
飞天小猴王	孙悟空-小猴子的故事	TheFlyingMonkid
四月一日灵异事件簿：春梦记前篇	xxxHOLiC:春梦记	XXXHOLic:Shunmuki-Zenpen
休息中的物体	一个静止物体
西游记的故事
小矮子的日记	thediaryofochibi	日本动画展览会第18话
蟑螂娘	Gokicha	CockroachGirls
电波女与青春男TV隐藏第13话
正义联盟：神明与怪物编年史第二季
代号Qualidea	QUALIDEACODE
我的小世界	MyLittleWorld
人间动物园	人间动物	HumanZoo
神无月的巫女	神无月的女巫	神无月的巫女
可美子的爱情	LoveofKemeko
圣诞老人接班人	Santa'sApprentice	L'ApprentiPèreNoël
神秘的第三颗行星	Taynatreteyplanety	TheMysteryoftheThirdPlanet
巴啦啦小魔仙之魔箭公主	巴啦啦小魔仙3	BalalaTheFairies:PrincessCamellia
皇家国教骑士团外传：黎明	Hellsing:TheDawn
植木的法则	Uekinohôsoku	植木的法则
交响情人梦最终乐章后篇	交响情人梦电影版2	NodameCantabile:TheMovieII
游往星空的鱼	Gotomyhome
巫婆、鳄鱼和小姑娘
AIURA	AIURA
你我故事的最后	TheEnd
南茜的早晨	Nancy'sMorning
干支魂	Etotama
沃土第一季
我叫MT第五季
怎样都行	纽约遇到爱	总之得就得
野蛮丛生
冬日恋歌动画版	WinterSonata:theAnimation
网球并不可笑嘛第六季	女子搞笑网球第六季	女高网球部第六季
樱桃小丸子真人版1	樱桃小丸子短剧版第一弹	樱桃小丸子真人版
装甲骑兵：大战	ArmoredTrooperVotoms：BigBattle	装甲骑兵：大战
大雄的结婚前夜
我叫MT第二季
我的妹妹小桃子	我的妹妹，小桃子	MySister,Momoko
皮卡丘与伊布们的好朋友	PikachuandEevee'sFriends	피카츄와이브이프렌즈
下课后第一季
FantasistaDoll	幻想玩偶	幻想人偶
文学少女今天的零食初恋	文学少女OAD
爱丽斯梦游仙境	爱丽斯漫游仙境	艾丽丝漫游仙境
古怪的人	古怪的人	TheEccentrics
尾随者竞技	尾随者竞技
守护猫娘绯鞠	守护者绯鞠	猫耳属性
TIGER&BUNNY特别版SIDEBUNNY
火车火车过山洞	WhoLastsLonger
男孩丹尼	男孩丹尼
猫和老鼠：罗宾汉和他的机灵鼠
变形金刚之狩魔之战：巨狰狞的崛起	变形金刚领袖之证狩魔之战：巨狰狞的崛起	变形金刚领袖之证野兽猎人
中华上下五千年
乱步迷案	TheMysteryofRampo	乱步迷案
Caillou
两颗Spica	我要上太空	两颗Spica
泰若星球	提拉星上的战争	塔拉星球之战
美丽密语	玛丽的故事	美丽蜜语
月球大冒险	带我去月球	月球探险记
代号D机关SP2	鬼牌游戏	JokerGame
摔香炉
王室近卫队	エルアールライセンスドバイロイアル
闯堂兔2疯狂马戏团	BraveRabbit2CrazyCircus
机动战士高达：一年战争秘史	机动战士高达一年战争秘闻录	MSIGLOOTheHiddenOneYearWar
街头音乐	街头音乐
小恐龙阿贡	GON
光明之泪X风	ShiningTearsXWind
鬼界超级混蛋	鬼界超级混蛋
我的世界：菜鸟历险记
月亮鸟	月亮鸟
青蛙王国	青蛙王国之我嘞个去	TheFrogKingdom
喜羊羊与灰太狼之懒羊羊当大厨	喜羊羊与灰太狼(第1031-1082集)	Paddytheamazingcook
鲁邦三世：风魔家族的阴谋	LupinIII:TheFumaConspiracy	鲁邦三世：风魔家族的阴谋
PhiBrain：神之谜	PhiBrain：神之谜
VomBäumlein,dasandereBlätterhatgewollt
一个叫欧维的男人决定去死	叫欧裴的男人	欧维决定去死
玛德莱克丝	マドラックス	异域天使
老猪选猫
暴走动画
黑白小姐	单色小姐	MissMonochromeTheAnimation
装甲骑兵	装甲骑兵波特姆斯	ArmoredTrooperVotoms
有求必应	土地公传奇
定格爱情小故事	定格爱情小故事
极黑的布伦希尔特	GokukokunoBrynhildr	BrynhildrintheDarkness
火烈鸟的骄傲	骄傲的火烈鸟
鲁邦三世：绿VS红	LupinIII:GreenVSRed	鲁邦三世：绿VS红
剧场版假面骑士555消失的天堂	KamenRider555TheMovie:ParadiseLost	MaskedRiderFaizTheMovie:ParadiseLost
丢失的围巾
骷髅13	骷髅13
装甲骑兵：荣耀的背后	ArmoredTrooperVotoms-KakuekitaruItan	装甲骑兵：荣耀的异端
无论如何都想加入生肖
狐狸与猎狗	狐狸与猎狗
忍者神龟第二季
卡若瓦猫	卡若瓦猫
乐高星球大战：新尤达编年史之突袭科洛桑
捉鬼特工队
战姬绝唱Symphogear	SenkiZesshōSymphogear
人与自然
猫的痛感	猫的痛感
吸血猫	にゃんぱいあ-theGothicWorldofNyanpire-
精灵高中之纽约	怪物高中之纽约
粉笔世界
今天的明日香OAD	天然萌少女明日香OAD
网球王子剧场版：二人的武士	二人的武士
同流者	随波逐流的人	Conformiste,Le
夜行神龙
幽体离脱	BodyJackOVA
伊老师与小蟾蜍大历险	伊卡博德和托德先生
恶搞之家第五季	搞怪一家人第五季	格利芬一家第五季
核爆默示录	核爆末世录	コッペリオン
飞碟说第一季	飞碟说
老摇椅上的汤姆	老摇椅上的汤姆
哐哐日记	哐哐哐
圣诞怪杰	苏斯博士的圣诞怪杰	Dr.Suess‘HowtheGrinchStoleChristmas
绯色的碎片第二季	绯色的欠片
最后的编织	TheLastKnit	最后的编织
狂野禁区	狂野禁区
工作狂人	HatarakiMan	工作狂人
梦比优斯奥特曼和奥特兄弟	UltramanMebiusandUltraBrothers
斧子警察第一季
功夫少林寺
重回猴岛
红死病的面具	MaskoftheRedDeath	MASKACRVENESMRTI
倒霉熊第二季
小小心声	小小心声	BornunderFire
诚实的玛德琳	诚实的麦德兰	诚实的梅德琳
怪医美女RAY
篮球男孩	灌籃少年	DEARBOYS	篮球男孩	灌籃少年	DEARBOYS
恰卜恰卜拯救圣诞节
变形金刚第二季	变形金刚
黑白无双
横山光辉三国志
兄弟战争TV未放送话
凹面鱼	NoodleFish	麵條魚
新宝岛
12只蚊子和5个人	十二只蚊子和五个人
赫伯·阿尔帕特和提加纳·布拉斯双重特点	赫伯·阿尔帕特和提加纳·布拉斯双重特点
架向星空之桥
霹雳震寰宇之刀龙传说	霹雳震寰宇之刀龙传说
庭中客	guestinthegarden
窃听风暴	他人的生活	别人的生活
上官海铃
手冢治虫消失了二十世纪最后之怪事件	二十世纪最后之怪事件	TezukaOsamuCollection-20CenturyLastMiracle
今天的明日香	天然萌少女明日香	KyounoAsukaShow
托马斯和朋友们：铁路大竞赛	汤马仕小火车之铁路大竞赛
西葫芦的生活	MyLifeasaCourgette
小夜游	LittleYeyos
黑猫警长第二部	新黑猫警长
钢索危情OVA1	钢索危情	TightRope
斑点猫	斑点猫
白马之子	白马之子
学生会的一己之见第二季	学生会的一存Lv.2
小柴犬阿旺的和风心	小柴犬阿旺的和风生活	小柴犬和风心
战国鬼才传
笨蛋的悲剧人生	笨蛋·悲惨世界	BakaMizeraburu
视而不见	ShiranPuri
布布和布布丽娜	日本アニメ見本市第27話	日本动画展览会第27话
三毛流浪记
后天的方向	后天的方向
Snow-White	BettyBoopinSnowWhite
XiAVANT	クロッシイ・アバン
猪八戒吃西瓜
终极蜘蛛侠第二季
聪明的顺溜	聪明的顺溜之雄鹰小子
TheAnimanVersionofCarmen
小精灵	捣蛋鬼	小魔怪
太空堡垒—暗影编年	太空堡垒—暗影编年
犬之旅店
女子落语	少女落语家	女子落
ACCA13区监察课
河童的饲养方法	河童飼養手冊
辛普森一家第八季	阿森一族	辛普森一家第八季
河狸白毛历险记	WhiteTuft,theLittleBeaver	河狸白毛历险记
哈姆太郎第二季	TottokoHamutaro:HamHamParadi-chu
修罗之介斩魔剑死镰纹之男
四神奇	不来梅的四重奏地狱中的天使
头文字DOVA	InitialDBattleStage
少年男仆库洛	庫洛君華麗的日常
棺材与天竺鼠	PunchandJudy
战地启示录
薄樱鬼剧场版第2章：士魂苍穹
飞毛腿冈萨雷斯	飞毛腿冈萨雷斯
MEMEMECHRONIC	日本动画展览会第20A话	日本アニメ見本市第20A話
食梦者特别篇	爆漫王3第0话	爆漫3第0话
卡波夫妇的剧院	Mr.andMrs.Kabal'sTheatre
剧场版BLOOD-CTheLastDark
我们的奇妙大自然	我们的奇妙大自然
网球并不可笑嘛第二季OVA	女子搞笑网球第二季OVA	女高网球部第二季OVA
H2O沙中足迹	H2O赤沙的印记	夏日阳光
铁马少年
穿长筒靴的猫	TheTrueStoryofPuss'NBoots	穿长筒靴的猫
47都道府犬
西米特拉的孤儿～波菲拉斯的漫长旅程	PorfynoNagaiTabi
啪嗒啪嗒	PadakPadak	Padak
未来日记OAD	未来日记OAD
金田一少年事件簿R	金田一少年事件簿2014	金田一少年之事件簿R
半妖少女绮丽谭	少女妖怪石榴	半妖少女绮丽谭
妄想学生会2OVA	妄想学生会2第15话
超电磁侠波鲁特斯V	ChoudenjiMachineVoltesV
宇宙战舰大和号2199第一章“踏上遥远的征途”
老虎和兔子：诞生	TIGER&BUNNY—Thebeginning
摇滚奥德赛
OZMAFIA	オズマフィア
银河护卫队2	GuardiansoftheGalaxy2
打开书	OpenBook
Tad’sNest
废弃公主	ScrappedPrincess	废弃公主
夫人与海女
RabbitPunch
泡芙小姐第六季：感爱季	泡芙小姐6	MissPuffSeason6
搜索吧部活剧再来一个	てさぐれ部活もの2期	搜索吧部活剧第二季
圣母在上OVA5：贵安，姊姊	玛丽亚的凝望
勇闯黄金城	勇闯黄金城	金国历险记
寄生兽：完结篇	寄生兽	Kiseijû:Part2
弹珠传说
银河飘流华尔分	Vifam	银河飘流华尔分
终极修炼
猫和老鼠：魔法戒指	猫和老鼠：魔法戒指
别抱我，我害怕3
我盛大的希腊婚礼2	我妈的希腊婚礼
牧羊犬德鲁比	牧羊犬德鲁比
神奇宝贝BestWishes	宠物小精灵BestWishes	口袋妖怪BestWishes
龙珠Z剧场版4：超级赛亚人孙悟空	超级赛亚人孙悟空	龙珠Z剧场版4
小猪宝贝	我不笨，所以我有话要说	宝贝小猪罗
别抱我，我害怕5
西湖传奇	玉龙还珠	LegendsofWestLake
双下山
别抱我，我害怕6
两个小洛特	两个小洛特
DC超能妹子：年度英雄
DC超能妹子第二季
一滴水	手塚治虫实验动画：一滴水	Shizuku
村正	手塚治虫实验动画：村正	Muramasa
剧场版超时空要塞F：虚空歌姬	超时空要塞F:虚空歌姬	劇場版マクロスF虚空歌姫イツワリノウタヒ
喜羊羊与灰太狼之开心方程式	喜羊羊与灰太狼第八季	喜羊羊与灰太狼(第971-1030集)
再取爱经
野天鹅	Dikielebedi	野天鹅
动物好伙伴
少年岳飞传奇	少年岳飞传奇
青云志	诛仙青云志
纵横四海	OnceaThief
夏季之门	Natsuenotobira	TheDoorIntoSummer
苍蓝钢铁的琶音剧场版：Cadenza
魔法老师	Mahôsenseinegima
超蛙战士之初露锋芒	超蛙战士	AniMen:TritonForce
地狱天使	HellsAngels
绯弹的亚莉亚AA	HidannoAriaAA	AriatheScarletAmmoAA
命运之夜天之杯第一章	剧场版命运之夜天之杯	Fate	staynightHF
开心超人2：启源星之战	开心超人2	HappyHeroes2QiyuanPlanetWars
网球并不可笑嘛第三季OVA	女子搞笑网球第三季OVA	女高网球部第三季OVA
很久很久以前	韩国民间传说故事
小米的森林
美女讨伐二人组	天使特警	KiddyGrade
关上最后的门	停驻你心门	关上最后的门
雨色可可
圣石传说	Shengshichuanshuo	LegendoftheSacredStone
出来吧小魔神胡帕
只有我不在的街道	只有我不存在的城市	有我不在的街道
鹦鹉螺号
列车厢	TheTrain
到那边
失物招领
蝴蝶泉	TheButterflySprings
迦南
鹤屋和熏干酪	鹤屋和熏干酪	Nyoron☆小鹤屋学姐
御先祖大人万万岁	祖先万万岁
小羊肖恩冠军羊咩咩
小叮当	小叮当真人版	奇妙仙子
亚当斯一家	阿达一族
打工声优	天籁之音	打工声优
臭屁小子	臭屁小子
怪盗Joker第2期
魔法咪路咪路
麦德兰	麦德兰
饥饿的地鼠	小贼囊地鼠	饥饿的鼹鼠
变身公主	公主公主	PrincessPrincess
如果她的旗帜被折断了	如果折断她的旗	KanojogaFlagwoOraretara
嘎喳嘎喳的鸟	唧唧喳喳的鸟	嘎喳嘎喳的鸟
动物之森	AnimalCrossing	动物之森剧场版
超时空要塞7	Macross7	新世纪超时空要塞
幽灵男孩
东方小故事
小孩的形而上学	AChild'sMetaphysics	KodomonoKeijijōgaku
untilYoucometome.	日本アニメ見本市系列第7话	日本动画展览会第7话
乐高积木世界
放浪男孩	流浪的孩子
机动战士高达：08MS小队-米娜的报告	机动战士高达：08MS小队-米娜的报告
魔剑美神REVOLUTION	秀逗魔导士REVOLUTION	魔剑美神REVOLUTION
ClipCultVol.1:ExplodingCinema
好逑双物语	好逑双物语
金箍棒传奇2：沙僧的逆袭	金箍棒传奇2	夺宝幸运星大电影之金箍棒传奇2
老夫子之魔界梦战记
约瑟传说：梦幻国王	约瑟传奇：梦幻国王
恶搞之家第六季	格利芬一家第六季	搞怪一家人第六季
导盲犬小Q	再见了可鲁	Quill
饮茶之功夫学园	饮茶S之功夫学园
琴岛·海尔	琴岛海尔	音乐岛
宇宙的巨人希曼第一季	宇宙的巨人希曼	He-Man
电波系彼女OVA1	电波系彼女
神奇宝贝：皮卡丘探险队	Pokemon:Pikachu'sRescueAdventure	宠物小精灵之比卡超探险队
布雷斯塔警长	星际警长
鸭子和野鸭子的投币式自动存放柜	家鸭与野鸭的投币式自动存放柜	家鸭和野鸭的投币式寄物柜
魔鬼恋人第二季	魔鬼爱人第二季
蛆蟲的17度空間
高地人：复仇之旅	挑战者：复仇	高地人：复仇之旅
幸运逻辑	Luck&Logic
梦色糕点师	夢色パティシエール
与魔共舞
2001夜物语TO	TO楕円軌道	TO共生惑星
Maisy	Maisy'sBirthdayandotherstories
兔子共和国	沃特希普高地	沃特希普荒原
故事中的故事	TaleofTales	Skazkaskazok
70亿只兔子
泡泡糖危机	Baburugamukuraishisu	BUBBLEGUMCRISIS
黑之宣告	Schwarzesmarken	黑色标记
玛利亚狂热	MariaHolic
里克和史蒂夫:全世界最快乐的同志伴侣第一季	里克和史蒂夫:全世界最快乐的同志伴侣
拉链小孩	拉链孩儿
左邻右里	左邻右里
惊爆草莓	惊爆草莓	StrawberryPanic
未确认进行式OAD	EngagedtotheUnidentifiedOAD:DuckMeatTastesaBitLikeGreentoMe.	MikakunindeShinkou
Bäckanäcken
鱼类的起源	鱼树
9.99澳元	幸福，十元有找	九块九毛九
真田十勇士第一部	新釈眞田十勇士
撸时代第一季
在水上	人生如行舟
竹剑少女竹刀少女	竹剑少女竹刀少女
御神乐学园组曲	MikaguraSchoolSuite
四圣兽-光阴叙事诗天使谭
WakeUp,Girls青春之影	WakeUp,Girls続･劇場版前篇
玉响毕业写真第4部：朝
妄想学生会OAD5	妄想学生会第21话	黄段子学生会OAD5
机动战士高达：重力战线	机动战士高达MSIGLOO2重力战线	MobileSuitsGundamMSIGLOO3_TheGravityFront
出云传奇	YakumoTatu
水漫金山	ThefloodingofJinshantemple	白蛇传动画版
热门小马	热斗小马	闪电怪马
妄想学生会新OVA1	妄想学生会第19话
传统艺继承部	Double-J	JJ萌艺社
星之人	星之梦续篇
西洋古董洋果子店	西洋骨董洋菓子店～Antique～	せいようこっとうようがしてん〜アンテ
花舞少女	花漾小屋百合开	Hanayamata
超时空要塞Plus剧场版	MacrossPlusMovieEdition
献给某飞行员的恋歌
船上的猫
梦不落帝国	梦不落帝国	小飞侠2002飞越梦幻岛
美雪，美雪	美雪，美雪
尼斯大冒险
机动战士高达0083星尘的回忆	機動戰士Gundam0083：STARDUSTMEMORY	MobileSuitGUNDAM0083STARDUSTMEMORY
芭蕾女舞者	天使爱芭蕾
童话高中第四季
善良的夏吾冬
乐高星球大战：尤达编年史之绝地大反击
境界的彼方TV未放送话	境界の彼方TV未放送話
海贼王剧场版4：死亡尽头的冒险	OnePiece:DeadEndnoBouken
夹子救鹿
外国人眼中的法兰西
某科学的超电磁炮SOVA	科学超电磁炮第二季OVB特典	ACertainScientificRailgunS:AlltheImportantThin
Gyrospter
眼泪的背后
街头霸王阿尔法	StreetFighterAlpha	ストリートファイターZERO-THEANIMATION-
刺客来山中狩猎了
宇宙人袭来
解脱了的光子
森林的安藤
戏剧性谋杀	ドラマティカルマーダー	DMMD
攻击东町2号
楳图一雄的诅咒	TheCurseofKazuoUmezu	Umezukazuononoroi
安妮·霍尔	安妮·荷尔	安妮·茜尔
彩虹舞	彩虹舞
爷爷在天上	GrandpaOutISeeYou
龙珠Z剧场版7：极限之战三大超级赛亚人	龍珠Z劇場版超級賽亞人極限戰鬥
黑美-动画制作进行	黑美-动画制作进行
小鱼历险记	鲨鱼总动员	AFishTale
奇天烈大百科	奇天烈大百科
盗贼王JING	盗贼王JING	KingofBanditJing
菊花笑典之有神么第二季
名侦探哥顿	名侦探哥顿
黛子小姐
魔法钢琴	TheWorldofFlyingMachine
WakeUp,Girls超越深限	WakeUp，Girls続･劇場版後篇
海底世界3D	海底猎奇	海底世界3D
魔力女管家	魔力女仆	Mahoromatic
无口的森田小姐	沉默的森田同学
功夫四侠
帽儿山的鬼子兵
派特和麦特大电影	派特和麦特
新地道战	NewTunnelWarfare
七武士
全职猎人OVA1	全职猎人OVA1
我叫MT剧场版2013：草裙娃娃
八九不离2
强迫症患者的血腥臆想	DIX
请问您今天要来点兔子吗	IstheOrderaRabbit
鱼风筝
女神异闻录4	Persona4theANIMATION	P4A
黑白小姐OVA2
马鸪先生的小车	Magoo'sPuddleJumper
和殿下一起～眼罩的野心～	和殿下一起～眼罩的野心～
三茶BLUES
爱的发明	机械爱	InventionofLove
月亮和孩子	月亮和儿子	月亮和孩子
妹妹公主	SisterPrincess
愤怒的小鸟：猪猪传	PigsatWork
摩登原始人之摔跤赛攻击波	石头族乐园	新聪明笨伯
强袭魔女2	内裤魔女2	强袭魔女第2期
落第骑士英雄谭	RakudaiKishinoCavalry	ChivalryofaFailedKnight
猥琐传说第一季	超屌火柴人	猥琐传说
巴布熊猫	BaboPan
抢狮头	搶獅頭
麻雀之歌	小麻雀的假期	鸵鸟走了
机动战士高达SEEDDESTINYHD重制
黑礁特典小剧场	BlackLagoonSP
超译百人一首歌之恋
MegandMog
蝴蝶姐妹
芭比之美人鱼历险记2	芭比之美人鱼历险记2
透明的孤独	InvisibleLoneliness
真魔神传	真魔神传	BattleRoyalHighSchool
金属外壳	MetalSkinPanicMadox-01
库里克的超越之路	兔子的日落大道	Crulic-ThePathtoBeyond
小羊肖恩：大追击
小小羊蒂米第一季	快乐小羊吉米	小羊肖恩外传
怪博士与机器娃娃	怪博士与机器娃娃	阿拉蕾
全职猎人剧场版：绯色的幻影	HUNTER×HUNTER剧场版
如影随形	如影随形
冲浪企鹅	滑浪奇兵	冲浪季节
精灵高中：闹鬼
好猫咪咪
神探加杰特第一季	gogo神探
达菲鸭
特别的她第二季	FoolyCooly	フリクリ
孤独的国王	孤独的国王
金田一少年事件簿：歌剧院最后的杀人	金田一少年之事件簿特别篇
彩虹小马：小马国女孩之友谊大赛
棕兔夫人	棕兔与飞蛾	棕兔夫人
逮捕令电影版	皇家双妹唛之东京攻略	逮捕令电影版：墨东署最大危机
公主追杀令
2013奥斯卡动画短片提名合集
小飞龙	海之子	海王子
中二病也要谈恋爱Lite	中二病也要谈恋爱ONA	ChuunibyouDemoKoigaShitaiLite
绊：恋爱的骚动
玛亚历险记大电影	DieBieneMaja-DerFilm（德）	LagrandeaventuredeMaja（法）
网中鱼	Fishinthetrap
瘪四与大头蛋第一季	BeavisandButt-Head	BeavisandButt-Head
死神剧场版：钻石星尘的反叛另一个冰轮丸	钻石星尘的反叛~另一个冰轮丸	死神剧场版2钻石星尘的反叛另一个冰
变形金刚：头领战士	变形金刚：头领战士
马达加斯加4
枕男子
丑小鸭
幽游白书~冥界死斗篇·炎之绊	Yuyuhakusho:meikaishitohen-hononokizuna
我的妈妈咪
冰雪女王	冰雪皇后	雪之女王
会飞的巫婆
BusyBuddies
银河英雄传说外传：朝之梦、夜之歌	银河英雄传说外传：朝之梦、夜之歌
我奇怪的爷爷	我的奇怪爷爷
球迷总动员	伟大的比赛	大决赛
粉红骑警
嘻皮拉君	HipiraKun
触不可及	闪亮人生	逆转人生
毁灭的历程	毁灭的历程
幻灵镇魂曲
休息时间	TimeOut
斩·赤红之瞳小剧场
八犬传+八犬传～新章～	LegendoftheDogWarriors-Hakkenden
象不象
彩虹小马	小马宝莉	我的小马驹大电影
神速のRouge	日本アニメ見本市第24話	日本动画展览会第24话
大头儿子和小头爸爸之草原奇遇
嘟嘟，嘘嘘，砰砰和咚咚	嘟嘟，嘘嘘，砰砰和咚咚
UpInTheAir
神风怪盗贞德	风神怪盗	KamikazeKaitouJeanne
向阳素描×☆☆☆特别篇
圣母在上OVA4：Ready,Go	玛丽亚的凝望	圣母在上OVA4：Ready,Go
奇異太郎少年の妖怪絵日記
小猪大行动	小猪大电影	小猪历险记
吸血鬼福尔摩斯
颠倒的帕特玛起始之日	SakasamanoPatema:BeginningoftheDay	倒置的Patma序章
外星人田中太郎	我的ET同学
超凡战队	恐龙战队	恐龙战队真人版
世纪末救世主传说北斗神拳2	HokutonoKen2	世纪末救世主传说北斗神拳2
明日边缘	异空战士	明日边界
深度空間69
西部牛仔
PleasuresofWar	圍城啟示錄
崔丝塔
无家可归的小孩	IenakikoRemi	HomelessChildRemi
重案组第四季
ハンドシェイカー	HandShakers
野狼前锋	踢出我天地
仓鼠的地狱
迷失的科伯特
车博士	ATuttoGas	YoroshikuMechadock
祈愿物语	祈愿物语	JunkersComeHere
放课后的职员室
超人：布莱尼亚克的攻击	超人：布莱尼亚克的攻击
阿大是我哥
战龙四驱	四驱小子中国版	GoForSpeed
熊出没之过年	BoonieBears:HomewardJourney
石原测试
蒙哥里历险记
科学忍者队	科学小飞侠	神勇飞鹰队
早安恋味蛋糕店	早安恋味糕点店	Bonjour-KoiajiPatisserie
找到这颗星球	IFoundAStar
驭星者闪亮的塔科特	银河美少年
电子头脑老太太	TheCyberneticGrandma
游乐场之吻	ワンダバキッス
德国人和意大利人的区别	ItalienaufDeutsch
如梦令
雪地灵犬3	小狗波图3
芭比之歌星公主
太空犬莱卡
终结的炽天使OVA吸血鬼夏哈尔
最终兵器少女	She,theUltimateWeapon	最终兵器少女
叽哩咕与男人和女人	KirikouandtheMenandWomen
Kuroko	你不是一个人
童话的另一种可能Red
浮士德	浮士德
宇宙一直线	uchuu_icchokusenn
阿拉丁和大盗之王
鲁邦三世：七日狂想曲	Lupinthe3rd:SevenDaysRhapsody
阿滋漫画大王短篇电影
阿曼动画之超级无敌掌门狗系列2	阿曼动画之超级无敌掌门狗系列2	华莱士与葛罗米特2
BLAME端末遺構都市
灼眼的夏娜：恋爱温泉的校外学习
无厘头短片2
一生二，二生三	Afteronecometwo,aftertwocomethree
妖精王	Youseiou	FairyKing
是魔法使的话就吃味噌	是魔法使的话就吃味噌
剧场版天地无用inLOVE2：遥远的思念	TenchiMuyôInLove2:Harukanaruomoi
鲁邦三世TV系列2	Rupansansei:PartII	TheNewLupinIII
歌之☆王子殿下LOVE1000%	歌之☆王子殿下	歌之☆王子殿下LOVE1000%
召唤恶魔阿萨谢尔OAD：路西法篇	よんでますよ、アザゼルさんルシファー編
史酷比	狗狗震	史酷比
風のように
阿衰
边城小镇
欧罗巴&意大利	意大利人不是欧洲人	意大利人与欧洲人的区别
游戏结束	游戏结束
亚瑟3：终极对决	亚瑟和他的迷你王国3	亚瑟3：终极对决
夺宝幸运星	开心西游记
动物总动员	动物会议	3D动物大会
魔法雪花
刀剑乱舞-花丸-
重返人猿星球	重返人猿星球
吉诺密欧与朱丽叶2：夏洛克·糯尔摩斯	Gnomeo&Juliet2	GnomeoandJuliet2
Alf,Bill&Fred
一只名叫痛苦的狗	PerrollamadoDolor,Un	ADogCalledPain
洋葱和尚朝太郎	洋葱和尚朝太郎
Free第二季ExtraFr
情况不妙	ABusyNight
ポッピンQ	POPINQ
圣斗士星矢：最终圣战的战士们	SaintSeiya:Saishûseisennosenshitachi
斧子警察第二季
功夫熊猫：盖世传奇第二季	功夫熊猫：非凡传奇第二季	功夫熊猫：大侠传奇第二季
去吧稻中桌球社	去吧稻中乒團	PingPongClub
水獭小宝贝第一季	水獭小宝贝
超级飞侠第二季
霹雳金光	霹雳布袋戏
自画像	自画像	自畫像
哥斯拉末世龙战	哥斯拉动画版
动画版蜘蛛侠	Spider-Man:TheNewAnimatedSeries	Spider-ManTheSeries
小小外星人	尖帽子的记忆
猫田のことが気になって仕方ない
鸭宝宝休易
质量效应：迷途楷模
霹雳劫之阇城血印
我是一个女孩子	日本アニメ見本市第31話	日本动画展览会第31话
雪狐
境界之轮回	CircleofReincarnation	RinneoftheBoundary
马戏团里的兔八哥
小马宝莉特辑之公主长廊	小精灵马：公主兜风
旋风管家第二季	旋风管家第二季
神偷卡门第一季	神偷卡门
小鸟游六花·改剧场版中二病也要谈恋爱
新世纪福音战士剧场版：复兴	新世紀エヴァンゲリオン劇場版RevivalofEvangelion	NeonGenesisEvangelion:Revi
我们没有羽翼	我们没有翅膀	OretachiniTsubasawaNai
デスティック·フォー	DEATHTIC④
玛莎和熊	玛莎与熊
圣诞老人公司	SantaCompany
萝球社	Ro-Kyu-Bu
星际旅行：动画版第一季	星际旅行动画版	星空奇遇记：动画版
微微一笑很倾城	微微一笑很倾城电视剧版	Weiwei'sBeautifulSmile
间谍亚契第七季
JET'AIME
喵星少年漂流记	十五少年漂流記海賊島DE大冒険	十五少年漂流记海贼岛大冒险
蝙蝠侠无极限：动物本能	蝙蝠侠无限：动物本能
乐高玩具的冒险之旅	乐高玩具的冒险之旅	乐高:古古治的冒险之旅
罗密欧的蓝天	Romeo'sBlueSkies	罗密欧的天空
可爱的羊驼：带小企鹅回家
四百二十连败女孩	Yonhyaku-NijuuRenpaiGirl
谍影重重5	叛谍追击5：身份重启	神鬼认证：杰森包恩
天才麻将少女：阿知贺篇特别篇「玄的生日」
地狱男爵动画版：铁血惊魂	地狱男爵动画版：铁血惊魂
浮草	DriftingWeeds	FloatingWeeds
HeartCatch光之美少女	揪心霹雳Q娃
鲁邦三世意大利游戏
魔镜奇缘	EnchantedMirrorRomance
猫拉面：我的酱油味
钢之炼金术师PREMIUMCOLLECTION
灵域第1季	Lingyu
文学少女回忆录1：梦见少女的前奏曲
三个证言者	日本アニメ見本市第17話	日本动画展览会第17话
忠犬八公的故事	忠犬小八	秋田犬八千
小公主莎拉	莎拉公主	小公主
伴你同行	COMEWITHME
富贵吉娃娃	比佛利拜金狗	走佬芝娃娃
牧羊犬郁金香	小杜与我	我的狗叫郁金香
BuggyNight
杰克奥特曼	归来的宇宙超人	归来的奥特曼
我们的存在	Bokuragaita	WeWereThere
创：崛起	创：崛起
圣斗士星矢(燃烧火焰的一击)	圣斗士星矢(燃烧火焰的一击)
打工声优take.2	天籁之音take.2
迪迦&戴拿&盖亚·奥特曼超时空的大决戦	奥特曼超时空大决战	UrutoramanTeiga&UrutoramanDaina&UrutoramanGaia:Choujikuun
强殖装甲凯普	KyôshokusôkôGuyver	强殖装甲凯普
火星需要妈妈	拯救老妈大作战	火星救母记
龙珠剧场版：摩诃不可思议大冒险	DragonBall:MysticalAdventure
虹猫仗剑走天涯
精灵高中:惊声尖拍	鬼魂高中
达仙德里亚
拉瓦拳星球	拉瓦拳星球
13只钟
有人赞美聪慧，有人则不	Don'tExpectPraises	ホメられないかも
风之又三郎
灵域第2季	灵域第二季
木偶奇遇记	匹诺曹
欢乐7福娘	欢乐7福娘
草莓棉花糖OVA2EncoreVOL.01	IchigoMashimaroOVA2Encore	Ichigomashimaroencore:Konnichiwa
奥兹国的桃乐西	奥兹国的桃乐西
めがちゅTheAnimation第三話
黑之契约者2：流星的双子	DarkerThanBlack:RyuseinoGemini	DarkerThanBlack:GeminioftheMeteor
漂亮爸爸	抓狂爸爸	漂亮爸爸
圣斗士星矢(挫败幻魔拳)	圣斗士星矢(挫败幻魔拳)
小魔法学园	小魔女学院	LittleWitchAcademia
神奇宝贝：雷皇·雷之传说	宠物小精灵之雷神传说	神奇宝贝：雷公·雷之传说
德鲁亚加之塔～乌鲁克之盾～	TheTowerOfDruaga:theAegisofUruk
捕鼠兄弟
亚特兰蒂斯：末日
黑白小姐第三季
在阁楼上有谁今天过生日	阁楼上的玩具	Napude
堀桑与宫村君OVA2	堀与宫村OVA2	HORI-sanToMIYAMURA-kunOVA2
圣斗士星矢(终于身世大白一辉之谜)	圣斗士星矢(终于身世大白一辉之谜)
骄傲的番茄	TOMATO
猴尘第一季
摩尔庄园2海妖宝藏	摩尔庄园2	LegendofTheMoles-TheTreasureofScylla
新钢铁神兵	ビート・エックスネオ	钢铁神兵OVA
团子大家族：另一个世界杏篇	CLANNAD～AFTERSTORY～藤林杏篇	那一个世界的杏
白马王子
赛车总动员3	汽车总动员3	飞车正传3
在盛夏等待特别篇
恶搞之家第八季	搞怪一家人第八季	格利芬一家第八季
歪小子斯科特对抗全世界	歪小子斯科特	斯科特对抗全世界
喜羊羊与灰太狼之飞马奇遇记	喜羊羊与灰太狼6	喜羊羊与灰太狼大电影6飞马奇遇记
喜羊羊与灰太狼之开心日记	喜羊羊与灰太狼第七季	喜羊羊与灰太狼(第911-970集)
虹色时光	虹色时光
太阳留住我	StopPeeping
迷糊餐厅特别篇LORDOFTHE小鸟游	迷糊餐厅第三季最终话
小飞象60周年限量版	小飞象60周年限量版
幻体续命游戏
机动战士高达SeedMSVAstray	机动战士高达SeedMSVAstray
海底大冒险	海底大冒险2	海底大冒险2：巨浪
甜饼狂欢节
憨豆先生卡通版第二季	憨豆先生动画版
蒼蠅拍拍拍
projectOMEGA	projectΩ
勇者王FinalOVA	GRANDGLORIOUSGATHERING
Q版三国	Q版刘关张
恶魔高校D×DNEWTV未放送第13话	恶魔高校D×DNEWOAD	恶魔高校D×D第二季TV未放送第13话
魔鬼芯片
红莲第三幕炎
超时空要塞7Encore	Macross7Encore
天地无用	TenchiMuyo	天地无用第一部TV版
古剑奇谭2：永夜初晗	古剑奇谭2：偃师传奇	GuJian2:LastNight
TheAmazingAdventuresofMorph
蜂蜜与四叶草	Honey&Clover	HoneyAndClover
小魔女莉莉：龙与不可思议之书	女巫莉丽：龙与不可思议之书	魔法师莉莉
全职猎人OVA3	全职猎人OVA3
乐高忍者大电影	乐高忍者	Ninjago
摩登原始人第三季	弗林特斯通一家	聪明笨伯
花粉少女注意報～THEANIMATION～みんなでエッチになっちゃえ
天才麻将少女：阿知贺篇	天才麻将少女第二季	咲-Saki-阿知贺编
偷脸贼	TheFaceThief	盗脸大盗
灌篮高手TV版特典	决意的湘北篮球部
超级玛丽	SuperMarioWorld
恐怖直播	死亡“动”新闻	恐怖攻击直播
初音岛	D.C.~DaCapo~	初音岛
BE-BOY	漂亮男孩
脱线先生	符碌先生	马古先生
纽约冰淇淋	纽约冰淇淋
战勇OVA：执事长之旅其二	執事長之旅其二
女装骑士	骑士德恩	双面骑士
电波女与青春男	Denpaonnatoseishunotoko	GroundControltoPsychoelectricGirl
间谍亚契第五季	Archer:Vice	邪道亚契
狐狸帽子
青空夏季篇前篇：山路	青空特别篇前篇：山路	AIR特别篇前篇：山路
古书新说
王子与108煞	王子与一百零八煞	水浒-108煞星
机动战士高达：铁血的奥尔芬斯第二季	机动战士高达：铁血的孤儿第二季
犬神同学和猫山同学	犬神同学X猫山同学
动画未来2011	青年动画制作者育成计划	青年动画人培养计划2010年度
阿甘妙世界第三季	阿甘妙世界
巴啦啦小魔仙	巴啦啦小魔仙大电影	BalalatheFairies
寂静夜1：吉尔伽美什的史诗
CHARGEMAN研	ChargeManKen
寻找圣诞老人	寻找圣诞老人
福尔摩斯在22世纪	福尔摩斯在22世纪
新世纪福音战士第0:0'话来自黑暗之光	NeonGenesisEvangelionGenesis0:0'TheLightfromtheDarkness
教室危机	Classroom☆Crisis
属性同好会	D-FRAGMENTS
疯狂的麦克斯4：狂暴之路	末日先锋：战甲飞车	疯狂麦斯：愤怒道
王尔德的夜莺与玫瑰
黑白小姐OVA
宠物小精灵：比克提尼与白英雄雷希拉姆	剧场版口袋妖怪BestWishes维库蒂尼与白之英雄
暗夜迷途犬	Dogs:Bullets&Carnage	ドッグス	バレッツ・アンド・カーネイジ
怪兽大战外星人外传：活死人萝卜之夜	活死人萝卜之夜
苍穹之法芙娜：逝者的权利	苍穹的法芙娜：逝者的权利	苍穹之战神：逝者的权利
圣斗士星矢
海底小纵队
我的小行星	MyLittlePlanet
伯爵与妖精	伯爵与妖精
战队长悠哉游哉的一天	全金属狂潮TSROVA——战队长悠哉游哉的一天	ARelativelyLeisurelyDayintheL
缉毒特搜班OVA	SwitchOVA
第一神拳TV特别篇冠军之路	HajimenoIppo-TVSpecial-ChampionRoad
强袭魔女	强袭魔女	机械化少女
从容的快板	新幻想曲	狂想曲
小鸟3号第一季	三只小鸟	小鸟三号
芭比之美人鱼历险记
愚人买鞋
厨房秘事
传说中的圣斗士奥路菲	SaintSeiya:TheHadesChapter-Inferno:Densetsunosaint,orphe	传说中的圣斗士奥路
希瑞&希曼圣诞特别篇
茶之芳香	茶之芳香
晴空剧场版	青空剧场版	鸟之诗剧场版
恶搞之家第十二季	居家男人第12季
钢铁守护者	ガドガード
超能机甲-高巴里安	海王星战士	超能机甲-高巴里安
美人鱼	Mermaid
黑白小姐第二季
没有耳朵的兔子和两只耳朵的小鸡	无耳兔与双耳鸡
阿拉丁神灯	一千零一夜	阿拉伯之夜
机器人R32的故事
风之圣痕	风之圣痕
数学城小兄妹第一季	数数城小兄妹	呜咪123
恋之魔法波波糖	まもってロリポップ	恋之魔法波波糖
青蛙王子	青蛙王子
蜡炬成灰
记忆沉睡的孩子奔向天空的摇篮	SleepTightMyBaby,CradledInTheSky
小驴托托
少年肯尼亚	ShounenKeniya
福音之殇	回水福音
麦克法兰之再生侠	再生侠	麦克法兰之卵
JOJO的奇妙冒险特别见面会WalkLikeCrusaders	SpecialEvent:WalkLikeCrusaders
人类衰退以后OVA：人类的弱肉强食	人类衰退以后SP
极速蜗牛：狂奔第一季	TurboFAST
猫钓鱼	猫钓鱼
饥饿游戏3：嘲笑鸟	饥饿游戏：自由幻梦最终章	饥饿游戏终极篇：自由幻梦2
四圣兽ova几千个昼与夜	四圣兽ova几千个昼与夜
战锤40000:极限战士	Ultramarines:AWarhammer40,000Movie
如此美好的一天
拖线狂想曲第三季	汽车闯天关：拖线狂想曲	汽车总动员：大话板牙
转动的桌子	转动的桌子
恶魔的新娘	恶魔的新娘
青之驱魔师京都不净王篇	蓝色驱魔师京都不净王篇	青之驱魔师第二季
大红狗	大红狗
拜见罗宾逊一家	未来小子	罗拨神奇家族
百鬼夜行抄	百鬼夜行抄
神奇宝贝：美洛耶塔的闪亮音乐会	Meloetta'sMoonlightSerenade
忍者杀手	NinjaSlayer
马路杀手的救赎
飞碟说第二季
飞碟一分钟第一季
黑色警报第一季	黑色代码	紧急救援
隐秘公主	おんみつ☆姬
蚂蚁历险记	TravelsofanAnt	蚁哥历险记
与魏茨曼野餐	PicnicwithWeissmann
机器肉鸡第一季	机器鸡第一季
猫拉面	猫先生拉面屋
不公正抽签OVA	不平衡抽签OVA	KujibikiUnbalance
机器鸡DC漫画特辑3：魔幻基友
四圣兽～圣兽降临编～	SaintBeast	四圣兽～圣兽降临编～
兔八哥大战糙山姆	兔巴哥大战燥山姆
兔八哥与坏蛋
老虎装牙
四处窜的杰瑞	四处窜的杰瑞
强袭魔女剧场版
脊椎的故事	向下看，向上望	ABackboneTale
老妇与鸽子	TheOldLadyandthePigeons	喂鸽老妇人的阴谋
我的小马驹：友谊大魔法第五季	小马宝莉
KISSKISSKISS
围棋少年2
魔法人力派遣公司	魔法使派遣会社	魔法使借贷公司
欢乐满人间	新欢乐满人间
稻荷恋之歌OVA	稻荷恋之歌第11话
老鼠在曼哈顿	老鼠在曼哈顿
浪漫时钟	RomanticaClock
秋之鼓点	动画未来2015：秋之鼓点	AkinoKanade
地藏
宠物小精灵：维库蒂尼与黑之英雄	剧场版口袋妖怪BestWishes维库蒂尼与黑之英雄	Pokémon14Movie
交响诗篇AO	EurekaSevenAO
喜羊羊与灰太狼之喜气羊羊过蛇年	喜羊羊与灰太狼大电影5	喜羊羊与灰太狼之冒险蛇年传
萌菌物语第2期	豆芽小文第2期
天命神童	TwinsofDestiny
猫城	CatCity	猫城
丛林拍档	天生顽皮
石中剑	Laespadaenlapiedra
机动战士高达：默示录0079	机动战士高达默示录0079
青蛙王子之蛙蛙探险队	青蛙王子2
爱杀宝贝OVA
告白实行委员会：告白预演
封神传奇	封神榜	3D封神榜
地狱来的黑魔娃娃
白色猎人	WeißKreuz
小魔法学园2	小魔女学园：魔法游行	LittleWitchAcademia:TheEnchantedParade
Hammy'sBoomerangAdventure
吸血姬美夕integral	VampirePrincessMiyu	吸血姬美夕integral
电话亭	ThePhoneBox	电话亭
超级无敌掌门狗之音乐奇迹	WallaceandGromitattheProms
幻想嘉年华特别篇	幻想嘉年华EX
马口铁玩具
恶搞之家第七季	搞怪一家人第七季	格利芬一家第七季
蚊子骑车大冒险	蚊子单车冒险	骑车的蚊子和跳舞的蚊子
魁拔IV	魁拔4	魁拔4之梅零落
草莓棉花糖OVA第1卷	草莓棉花糖OVA第1卷
疯狂进化人	我怎么能吃我爸爸	我为什么吃我的父亲
金翅雀	Yellowbird
超时空要塞F剧场版后篇：恋离之翼	剧场版MacrossF~再见之翼
杀戮公主	虐杀姬	マーダープリンセス
口香糖男孩	AGumBoy
稻荷恋之歌	狐仙恋爱入门	Inari,Konkon,KoiIroha
双人舞	双人舞
奇迹列车	Miracle☆Train	ミラクル☆トレイン
森林河流之旅
莫日根	莫日根：人熊大战	MorengenBearvsMan
受罪猫	受罪猫
恶搞之家第十一季
小公主苏菲亚	公主传奇	小公主苏菲亚剧场版
疯味英雄	Beyondtheworlds
莱昂纳多的日记	Leonardo'sDiary
极上生徒会	极上生徒会	GokujoSeitokai
洛克王国之圣龙骑士	洛克王国圣龙骑士	TheDragonKnight
奇幻森林2	丛林之书2	森林王子2
狮子胯下	UndertheLionCrotch
特別篇I哈姆太郎的生日~尋找媽媽三千走走	HamtaronoOtanjoubi~MamawoTasuneteSanzenTechiTechi~
美丽的生命	美丽人生
幻影少年	MonochromeFactor
光环战争	光晕战争
青蛙军曹第二季	Kerorogunsô
侵略乌贼娘OAD
辛普森一家第五季	辛普森家族	阿森一族
苹果核战记	苹果核战记OVA	Appurushîdo
八仙与跳蚤
Bill'sDirtyShorts
彩色盒子	彩色盒子
少年女仆
Q版RWBY
霹雳侠影之轰动武林	PILIXIAYING：THEWULINWARRIORS
Hello黄金拼图	黄金拼图第二季
超级英雄的一天第二季
女皇之刃~美丽女斗士们	女皇之刃~美丽女斗士们
海贼王特别篇：强者世界前传	OnePieceMovieStrongWorldEpisode0
魔都传奇	'Brave'TellsTheLegendofMor'du
妙先生之火泽睽笑人传	妙先生
十二生肖城市英雄
学园救援团	SketDance
怪物盒子
雷加利亚三圣星	RegaliaTheThreeSacredStars
兔侠传奇	兔侠	LegendofARabbit
精灵使的剑舞	BladedanceofElementalers	SeireiTsukainoBladeDance
亡国的阿基德第2章：翼龙折翅	CodeGeass亡国的阿基德第二章「翼龙折翅」
小飞象	小飞象真人版
魔法战争	MahouSensou
亡国的阿基德第3章：辉芒陨落	CodeGeass亡国的阿基德第三章「辉芒陨落」
今天的5年2班
召唤恶魔阿萨谢尔OAD：海葵篇	よんでますよ、アザゼルさんイソギンチャク編	恶魔阿萨谢尔在召
苍蓝钢铁的琶音剧场版
攻壳机动队：崛起4	攻壳机动队ARISE4	GhostintheShellAriseborder:4GhostStandsAlone
小女神花铃	KamityamaKarin
迷你偶像第二季
恐龙特急克塞号	恐龙战队	DinosaurTaskforceKoseidon
女皇之刃王座继承者	女皇之刃王座继承者
RE:人造人009
DC展台：猫女	DC展台：猫女
结城友奈是勇者	YukiYunaIsaHero
消防狗	消防狗
樱桃小丸子电影版我喜欢的歌	樱桃小丸子剧场版我喜欢的歌	樱桃小丸子电影版我喜欢的歌
兔宝的悲惨日常第二季	兔宝的悲惨日常：觉醒篇	乌瑟的穷困生活第二季
宫河家的空腹	Miyakawakenokuufuku
蓬勃的生活	生活，动画
鲁邦三世Episode：0初次交锋	LupinIII:Episode0-FirstContact	鲁邦三世Episode：0初次交锋
噬神者	GodEater
反叛的鲁路修娜娜莉梦游仙境	codegeassnunnallyinwonderland
罪夜之奔	纽约杀人夜	谜之罪夜
辛普森一家之恐怖树屋第十九部	"TheSimpsons"TreehouseofHorrorXIX	辛普森一家之恐怖树屋第十九部
第一神拳TV未放送第76话：拳王之拳	第一神拳第一季TV未放送话	HajimenoIppoTheFightingRound76Boxer'sFist
雏蜂
痞子猫	BadCat
ClassicalBaby(I'mGrownUpNow):ThePoetryShow
copihan
大教堂	TheCathedral	大教堂
开心汉堡店第二季
侵略乌贼娘OAD2
丑小鸭
疯狂的萝卜
现视研2代目	现视研第三季	现代视觉文化研究会2代目
芭比之完美圣诞
I''sPure
雪之少女	雪姑娘	Snegurochka
赛场大反攻	热斗小斑马	斑马竞赛
铠甲勇士刑天	铠甲勇士第二部：刑天
万有引力OVA	GRAVITATIONOVA	万有引力OVA
鲁邦三世：宝物返还大作战	LupinIII:OperationReturntheTreasure
美人鱼	Mermaid	Rusalka
告白实行委员会剧场版
别抱我，我害怕2:时间
白雪公主与青蛙王子
白色相簿	纯白相薄	白色相册
柔王丸	无敌三四郎	遥控机器王
辛普森一家第十三季	辛普森一家第十三季
大丹麦狗马默杜克	大丹麦狗马默杜克	鬼马嘟嘟狗
迪奥传说	レジェンドオブ・デュオ
圣斗士星矢冥王神话第2章	圣斗士冥王神话第二季
摸索吧部活剧	摸索社团活动	探索部
九蟒戏	勇敢者的游戏
龙族拼图X	龙族拼图X	智龙迷城x
最后15分钟
怪杰佐罗	佐罗传奇	佐罗的传说
宾波的魔桶
宠物小精灵：裂空的访问者	宠物小精灵:裂空的访问者
图书馆战争：恋之障碍	图书馆战争TV未放送第13话	LibraryWarOVA:SituationLoveHandicap
兔八哥之兔子快跑
仲夏之梦	理想国奇遇记	精灵总动员
绳舞	RopeDance
糖果世界大冒险	绿林大冒险之糖果世界	绿林大冒险2
神驼马	TheHumpbackedHorse
花园里的独角兽	花园里的独角兽
嘻游记	武林笑传	TheSwordmanDream
琴浦小姐	琴浦桑
三个火枪手	ワンワン三銃士	DogtanianandtheThreeMuskehounds
霹霹乐翻天
小科学怪人	小科学怪人	科学怪狗
满足巴克	姑娘，我爱你，可...	满足巴克
爆竹风波
勇者指令	YuushaShireiDagwon
苏生龙王传说	龙王传说	Legendz
功夫兔系列3：菜包狗大反击	KungfuBunny3
终极复仇者	最后的复仇者们
不思议游戏OVA1	不可思议的游戏OVA1后篇
创星大天使	创圣大天使OVA：背叛之翼&太阳之翼
天鹅公主	天鹅公主
偷偷爱着你	花样少男少女	花君
火星上的小老鼠	火星上的冒险家	老鼠火星历险记
替身：因果	Another第0话	アナザーOAD
蛋黄酱萝莉	POTEMAYO	蛋黄酱萝莉
我女友与青梅竹马的惨烈修罗场	俺修羅	夾在我女友和青梅竹馬間的各種修羅場
科学小飞侠Crowdsinsight	科学小飞侠Crowds第二季	GATCHAMANCROWDSinsight
私立荒矶高等学校生徒会执行部OVA	ShiritsuAraisoKoutouGakkouSeitokaiShikkoubuOVA
生存游戏社OVA
上课小动作特典：玩雪	邻座同学是怪咖第23话	MyNeighborSekiOVA:SnowPlay
我要成为双马尾	我，要成为双马尾	Ore,TwintailsniNarimasu
薄樱鬼～御伽草子～
派对焦点	派对焦点
W-两个世界	W:TwoWorlds	W-dugaeuisegye
学战都市Asterisk	学战都市六芒星
老婆婆的枣树
幽幻怪社	PhantomQuestCorp
罪恶王冠：罪亭冠云	罪恶王冠特典
魔乳秘剑帖
圣母在上4	圣母在上第4季
泡芙小姐第五季	泡芙小姐寻找季
只有神知道的世界女神篇	只有神知道的世界第三季
绝对双刃	AbsoluteDuo
猫咪不跳舞	猫不跳舞
扑杀天使2	扑杀天使朵库萝第二季
魔法骑士	魔法骑士雷阿斯	魔法骑士雷亚斯
杨·史云梅耶的短片集：早期篇	杨·史云梅耶的短片集：早期篇
北京房事	北京@房事
今天开始恋爱吧2	今日，开始恋爱
机动刑事808	サイバーシティOEDO808	CYBERCITYOEDO808
噬魂师NOT	souleaternot
魔物娘的同居日常	魔物娘的相伴日常	MonsterMusumenoIruNichijou
宝石の国
螳螂捕蝉	AStoryinSummertime	ThePrayingMantis
狂奔的犀牛	RhinoFullThrottle
梦幻之星Online2	PhantasyStarOnline2
法外制裁者	不存在的人	Code:Breaker
白寡妇行动
校园乌托邦学美向前冲	GakuenUtopiaManabiStraight	校园乌托邦学美向前冲
神秘博士：无极
魔奇少年第二季	天方魔谭MAGI第二季	魔笛第二季
憨豆先生卡通版第一季	憨豆先生动画版	憨豆先生动画系列
菠萝鱿鱼
黑暗边缘	黑暗终结者	梦网之星
东京扫描仪	TokyoScanner
狐狸列那	列那狐
恋爱舞台OAD
呆伯特	呆伯特
弃宝之岛：遥与魔法镜	弃宝之岛：遥与魔法镜
第一神拳第三季	はじめの一歩Rising
戴帽子的猫	反斗灵猫	魔法灵猫
蝉噪林愈静	中国动画现状实录
梦回金沙城	TheDreamsofJinsha	MengHuiJinShaCheng
绅士决斗	绅士的决斗	绅士决斗
全职高手动画版
兽兵卫忍风帖：龙宝玉篇	NinjaScroll:TheSeries
阿滋漫画大王	Azumangadaiô
圣母在上：春	Mariasamagamiteru:Haru	玛莉亚的凝望
创造性遗传基因	DeepImagination
健康全裸系游泳部-海商	健康全裸游泳部
浮世物语	Contedumondeflottant,Le
旋风管家第三季	爆笑管家：双眼只有你	新旋风管家
龙珠剧场版：神龙传说	DragonBall:TheLegendofShenron	DragonBallMovie1
星际漫步第一季	宇宙小奇兵
时间的皱折	时间的皱纹	奇幻时空历险
俏皮小花仙	FloralElfMaryBell
山T老夫子	E.T.老夫子	山.T老夫子
死亡空间：余波	死亡空间：劫后余生	死亡空间：余波
小战象2	大象将军2	小战象II
最终幻想7：终极指令	最终幻想VII最终命令
展览会上的画	图画展览会
复仇者集结第一季	AvengersAssemble
上锁的房间	上锁的房间
圣传：冰城炎狱篇	圣传-冰城炎狱篇
新白雪姬传说	Pretear
谜样女友X	迷之彼女X	情迷口水妹
当女孩遇到熊OVA1：初雪之日
家有贱狗	家有傻犬	BowWow
菲力猫	菲力猫
忘れ星
我的小马驹：友谊大魔法第四季
高桥留美子剧场	RumikoTakahashiTheater	高桥留美子剧场
萩萩公主	プリンセスチュチュ	萩萩公主
第一神拳	HajimenoIppo	第一神拳
我的小马驹：友谊大魔法第三季	彩虹小马（台）
笨蛋·测验·召唤兽：祭	笨蛋、测验、召唤兽OVA
轮回的拉格朗日第二季	RinnenoLagrange:Flowerdeclarationofyourheartseason2	Lagrange:TheFlowerofRin-nesea
秀逗魔导士Gorgeous	SlayersGorgeous
机动战士Z高达	MobileSuitZetaGundam
双斩少女TV未放送话	キルラキル特別編	KillLaKill:GoodbyeAgain
海贼王剧场版2：发条岛的冒险	海贼王剧场版：发条岛的冒险	Onepiece:ClockworkIslandAdventure
古斯柯布多力传	TheLifeofGuskouBudori
机动战士高达0083吉翁的残光	MobileSuitGundam0083LastBlitzofZeon	机动战士高达0083自护的残光
小鸡不好惹之咸蛋寺
飞哥与小佛第三季
机动新世纪高达X	機動新世紀ガンダムＸ	机动新世纪高达X
告白实行委员会：嫉忌的答复
AKB0048第二季
圣母在上OVA2：暂定为OK大作战	玛丽亚的凝望
马鸪飞去时	马鸪飞去时
散华礼弥OAD3	散华礼弥TV未放送14话	身为僵尸…心为…心中带刺的女人
飞行猫	飞行猫
棒球大联盟第一季	MAJORSeason1
TheManCalledFlintstone
光速蒙面侠21	Eyeshield21	光速蒙面侠21
北斗神拳拉欧外传天之霸王
大耳猴	Cheburashka	ЧеБурашка
彼得兔和朋友们的世界	彼得兔的世界
漫画少女OVA	漫画少女TV未放送第14话	MangirlOVA
猫和老鼠传奇第二季
再造人卡夏	再造人卡辛	CasshernSins
弗兰克·史丹的狂迷	科学怪人
寻找卡米洛城	寻找卡米洛城	卡麦勒传说
青空夏季篇后篇：天地	青空特别篇后篇：天地	AIR特别篇后篇：天地
Wolfwalkers
库伊拉·德维尔	101真狗	101Dalmatians
蝙蝠侠:迷雾奇日	蝙蝠侠75周年纪念短片
妖精的尾巴：欢迎光临妖精女生宿舍
放牛班的春天	歌声伴我心	唱诗班男孩
圣斗士星矢:黄金的苹果	SaintSeiya,JashinEris	SaintSeiyaGekijôban
星际5555：异星梦系统秘传	The5toryofthe5ecret5tar5ystem
寻龙诀	乌尔善版鬼吹灯	鬼吹灯之寻龙诀
关于我被绑架到大小姐学校当庶民样本这件事	我被绑架到贵族女校当庶民样本	我被绑架到贵族女校当“庶民样本”
德克斯特的实验室第四季	Dexter'sLabSeason4	DexterdeShiyanshiSeason4
吸血丸	Chi-SuiMaru
杀死比尔	追杀比尔	标杀令
灼眼的夏娜炭	しゃくがんのシャナたん
人造人009	再造人009	人造人009
圣堂教父	英雄本色	Sanctuary
尸体派对OVA：迷失的舞步	尸体派对：迷失的舞步	CorpseParty:MissingFootage
城下町的蒲公英	CastleTownDandelion	JoukamachinoDandelion
侵略乌贼娘二期	侵略乌贼娘二期
多啦A梦族：虫虫跳跳大作战
查理布朗的圣诞节	花生精选之查理布朗的圣诞节	查理布朗的圣诞节
美少女战士S	美少女战士第三季	BishoujoSenshiSailorMoon
机动战舰剧场版：暗黑王子	機動戦艦ナデシコTheprinceofdarkness	KidôsenkanNadeshiko:PrinceofDarkness
政宗君的复仇
圣枪修女	ChrnoCrusade	ChronoCrusade
神秘的黄金城	TaiyônokoEsteban	TheMysteriousCitiesofGold
浜虎第二季	滨虎第二季	リプライハマトラ
Revolution-LaBelleFrance
HappyBirthdaySwitzerland
快乐东西4
鼻毛真拳	鼻毛真拳
呆呆精灵	疯狂鬼幽灵	古堡幽灵韦布
迷你偶像	ぷちます-PETITIDOLM@STER-	偶像大师Q版
怪兽酒场干杯
通缉曲	蛋蛋牛仔
苍之彼方的四重奏
纯情房东俏房客圣诞特别篇	LoveHinaChristmasSpecial
痞子英雄	痞子英雄
巴别塔之书	巴布尔的书	Bavel'sBook
四叶OVA第1话	四叶OVA第1话	YotsunohaOVAvol.1
四叶OVA第2话	YotsunohaOVAvol.2	四叶OVA第2话
亚当斯一家	阿达一族	爱登士家庭
牙狼炎之刻印	牙狼动画版	Garo:HonoonoKokuin
牧神的午后	牧神的午后
卢西塔尼亚号的沉没	卢西塔尼亚号的沉没
黑冢	Kurozuka
飞行的奇迹
天气先生
口袋妖怪BestWishes2	神奇宝贝BW2	宠物小精灵BW2
TobyTortoiseReturns
辛普森一家之万圣节专辑之恐怖树屋	阿森一族之万圣节专辑之恐怖树屋	TheSimpsons-TreehouseofHorror
寻找满月	星河满月	满月美眉
爱丽丝梦游仙境	爱丽丝梦游仙境
海力布	猎人海力布
三只小狼	三只小狼
小屁孩日记	逊咖冒险王	囧男孩日记
令人战栗的日本昔话	YonimoOsoroshiiNihonMukashibanashi
小熊维尼	小熊维尼真人版
战勇OVA：执事长之旅其一
淘气包马小跳
科学小飞侠Crowds	GatchamanCrowds	神勇飞鹰侠Crowds
Chezmoi	MyHome	媽媽的鳥情人
怪童丸	Kaidohmaru
鲸鱼的腹部	谜一样的鲸鱼肚
无齿之徒
妖怪的日常	Thedailylifeoftheghosts
黄金小子	黄金男孩	漂泊的流浪小子
伊格曼与时间
魔法少女奈叶	MagicalGirlLyricalNanoha	魔法少女奈叶
BLAME	ブラム	BLAME劇場版
鬼眼狂刀	SamuraiDeeperKyo
辛普森一家第七季	辛普森一家
BuriedTreasure	EvereadyHartoninBuriedTreasure	PeckerIsland
水孩子
犬神同学和猫山同学OVA	犬神同学X猫山同学TV未放送話
哈利·波特与密室	哈利波特2：消失的密室
仙界传封神演义	SenkaidenHôshinengi	SoulHunter
恶魔人诞生篇	Devilman:TanjouHen	恶魔人诞生篇
狮子护卫队：咆哮归来	狮子卫队：咆哮归来
深坑、钟摆和希望	深坑、钟摆和希望
混乱达菲鸭	混乱达菲鸭
否否正能量	FOFandHisStory
龙珠Z剧场版6：激突100亿能量的战士们	DragonBallZMovie6	激突100億能量的戰士們
InternetExplorer:TheAnime
天狗食月
草莓棉花糖OVA2EncoreVOL.02	草莓棉花糖OVA2EncoreVOL.02
猪仔值班	Piggy'sDuty
コントころしや1989	COMEDYSKIT1989	日本动画展览会第26话
鸡先生	一只鸡的12分钟鸡生
巴黎淘气帮	小淘气尼古拉	反斗小尼哥
Moxie	莫克西的奇幻旅程
薄樱鬼OVA：雪华录	薄樱鬼：雪华录
胡桃夹子	胡桃夹子真人版
无忧无虑	HAKUNAMATATA
七人魔法使	魔道书7使者	TrinitySeven-7-ninnoMashoTsukai
杨·史云梅耶的短片集：后期
第一神拳间柴vs木村死刑执行	HajimenoIppo:Mashibavs.Kimura	第一神拳OVA
咪姆	Meme’sFantasticAdventure	ミームいろいろ梦の旅
正义联盟：神明与怪物编年史第一季	正义联盟：神明与怪兽编年史	正义联盟：神魔编年史
MonkeyPunch的世界爱丽丝	MonkeyPunch'sWorld:Alice	MonkeyPunch的世界爱丽丝
限制级杀手	theHiredGun
熊出没之夺宝熊兵	熊出没大电影	熊出没电影版
阴郁的夜晚	阴郁夜晚	日本アニメ見本市第22話
九层妖塔	陆川版鬼吹灯	鬼吹灯之九层妖塔
非典型高中生活第一季
海的女儿新历险记	海的女儿新历险记
功之怒	功夫怒汉	功夫之怒
亡国的阿基德第1章：翼龙降临	CodeGeass亡国的阿基德第一章「翼龙降临」
搜神记
我的朋友小海豚
小神龙俱乐部	TheDragonClub
金田一少年事件簿123亡霊学校殺人事件2	DepartedSpiritSchoolMurderCase:File2
狗狗巡逻队	汪汪队立大功
圣母在上OVA1：小羊们的假期	玛丽亚的凝望	圣母在上OVA1：小羊们的假期
埃及金字塔
圣母在上OVA3：凉风飒飒	玛丽亚的凝望	圣母在上OVA3
赛尔号	赛尔号第一季
回家乡的果子
哈利·波特与魔法石	哈利波特1：神秘的魔法石
神奇校巴	Scholastic'sTheMagicSchoolBus	神奇校巴
兔宝的悲惨日常TV未放送第13话
反叛的鲁路修特别篇：暗黑的背叛	CodeGeass:LelouchoftheRebellion-SpecialEdition-BlackRebellion
赤足小子	赤足的小元	HadashinoGen
AKB0048	AKB0048
魔力女管家2	魔力女仆2	魔力女管家：更美丽的事物
东京巴比伦	東京BABYLON
波莱罗	Bolero
乐高蝙蝠侠大战超人2
柳林风声	风语河岸柳	杨柳风
金刚葫芦娃	葫芦小金刚第二部
新机动战记高达W总集编1	NEWMOBILEREPORTGUNDAM-WODD&EVENNUMBERSOPERATIONMETEOR
新机动战记高达W总集编2	NEWMOBILEREPORTGUNDAM-WODD&EVENNUMBERSOPERATIONMETEORII
艾米莉亚和杜瓦特
小熊维尼与大风吹	小熊维尼与大风吹
色彩幻想	色彩幻想
魔动王冒险篇	MadôôGuranzôto
给面码的信
恶搞之家第三季	搞怪一家人第三季	格利芬一家第三季
金钻鼠王	TheHairyToothFairy
剑勇传说	九龙珠	城市风云儿
疯狂兔宝宝	无敌兔宝宝	DraganjuskaDuskaDugouska
美丽人生	一个快乐的传说	LifeIsBeautiful
楚门的世界	真人Show	真人戏
中学星	Chu-gakusei
怪猫费力德
凉风	Suzuka
星星公主	Narutaru:Mukuronaruhoshitamataruko	ShadowStarNarutaru
贤二前传之宝藏传奇
马可波罗历险记	马可波罗返香都
新网球王子OVAvsGenius10	新网球王子新OVA
死神来了	死亡失败
小熊维尼历险记	小熊维尼历险记
布偶大电影之最高通缉	布偶大电影2	布偶历险记：全面追缉
神奇宝贝：皮卡丘的冬季假期1999	宠物小精灵：比卡超的冬季假期1999	神奇宝贝：皮卡丘的冬季假期1999
轻音少女番外篇：LiveHouse	K-OnLiveHouse
地狱男爵2：黄金军团	烈焰奇侠：黄金军团	地狱怪客2：金甲军团
素描本	写生簿	素描簿
比基尼勇士	BikiniWarriors
圣战士罗宾	星战三勇士	银河圣战士
马克·吐温的冒险旅程	CometQuest:TheAdventuresofMarkTwain	马克·吐温历险记
阿拉德战记	地下城与勇士
课长王子	TheLegendofBlackHeaven	课长王子
恋爱心跳接吻
至高指令	BigOrder
铳梦
魔法禁书目录茵蒂克丝炭	茵蒂克丝碳	ToaruMajutsunoIndex-tan
鳄鱼街
生活大爆炸第七季	天才也性感第七季	天才理论传第七季
奇诺之旅OVA：塔之国	奇诺之旅：塔之国
圣哥传OAD2
食梦者	爆漫	爆漫王
借东西的小人阿莉埃蒂：创作的秘密	宫崎骏与新人导演的400天
死神时刻
艾克斯奥特曼剧场版：来了我们的奥特曼
荷包蛋的蛋黄啥时戳破好	荷包蛋的蛋黄什么时候戳破才好	何时捣碎煎蛋黄
波波安第二季
小羊肖恩：农夫的美洲驼
奇奇颗颗历险记
足球小将欧洲大决战	CaptainTsubasa-SoccerBoysEuropeFinals	足球小将之决战欧洲
混沌之脑	カオスヘッド	混沌头
攻壳机动队	攻壳机动队真人版
深渊传说	TalesoftheAbyss	深渊传说
小棕熊探险记
袜子奇遇记	衣服总动员
血腥约会	BloodyDate
神臂	神臂	欲望神臂
海棠依旧	我的伯父周恩来
喜羊羊与灰太狼之羊羊小心愿	喜羊羊与灰太狼第十季
双程	ARoundTriptoLove
革命机Valvrave	ValvravetheLiberator
假面骑士亚马逊们	KamenRiderAmazons
2015奥斯卡动画短片提名合集
手风琴	Accordion
阿松3.5话	阿松第3.5话
香蕉超人	香蕉超人
地球守护者	地球守护者
玛利亚狂热第二季	玛利亚狂热：活着	MariaHolicALIVE
团子大家族第二季番外篇：一年前的事
西部大懒猫
亚马逊萌猴奇遇记	绿色星球	萌猴大冒险
弥留之国的爱丽丝game1
德克斯特的实验室第三季	Dexter'sLabSeason3	DexterdeShiyanshiSeason3
百年幻影	百年幻影	螺石幻境
类型片大赏	类型片大赏
TheTannery
乔治和AJ
长发公主	魔发奇缘	长发姑娘
TheSuperman	AquamanHourofAdventure
心理治疗	PSYCHOTHERAPY
我为杰瑞狂	我为杰瑞狂
陷入绝境的猫	陷入绝境的猫
进步与机械化	进步与机械化
羊羊游世博	喜羊羊与灰太狼
宠物小精灵：决战时空之塔帝牙卢卡VS帕路奇犽VS达克莱伊	DialgavsPalkiavsDarkrai
Amon：恶魔人默示录
差不多
恶魔高校D×DNEW	HighSchoolDxDNew	恶魔高校D×D2
机器肉鸡：星战特辑
暧昧萌Canchange	萌幻变身OVA	AiMaiMoeCanChange
黑水晶	魔水晶	夜魔水晶
鲁邦三世TV版系列1	鲁邦三世TV版系列1
变形金刚第四季	变形金刚
时光诡域	theprisonersoftime
地狱男爵动画版：风暴之剑	地狱男爵动画版：风暴之剑
真·恋姬无双：乙女大乱
端脑	端脑大电影
机动战士高达SEEDHD重制
大都会	科学世界
丹特丽安的书架OAD	丹特丽安的书架OVA
热带雨林的爆笑生活完结篇	热带雨林的爆笑生活FINAL
明日之后	末日浩劫
凡爾賽的玫瑰	凡爾賽的玫瑰
打鸡蛋	TheKillingofAnEgg
向阳素描第三季	向阳素描第三季	向阳素描☆☆☆
杨·史云梅耶的柜子
母牛总动员	牧场是我家	放牛吃草
火影忍者剧场版：木叶大运动会	火影忍者OVA3
DIY卡通套装	DIY卡通套装
机巧少女不会受伤特典	UnbreakableMachine-DollshortOVA	Mashin-DoruwaKizutsukanaishortOVA
降世神通：都市暗影	降世神通：喧嚣之城
蝙蝠侠：黑暗骑士	蝙蝠侠前传2：黑暗骑士	黑暗骑士
上课小动作特典：林间学校	邻座同学是怪咖第22话	MyNeighborSekiOVA:FieldTrip
数码宝贝大电影三：超绝进化黄金的数码装甲	数码暴龙02大电影
头文字D第五季	头文字D第五部	InitialD:FifthStage
偶像活动	Aikatsu
灰色的迷宫	LeLabyrinthedelaGrisaia	GrisaianoMeikyuu
真假李逵
钢铁侠与美国队长：英雄集结
仙剑奇侠传三	仙剑奇侠传3	ChinesePaladin3
灰色的乐园	TheEdenofGrisaia	LeEdendelaGrisaia
超时空要塞外传	超时空要塞Plus	MacrossPlus
真的有呀灵媒先生	ReallyExistedSpiritMediumTeacher	HontoniAttaReibai-Sensei
蝙蝠侠大战幻影人	蝙蝠侠之鬼影之战	蝙蝠侠大战幻影人
超级无敌掌门狗：异想天开小发明	超级无敌掌门狗：异想天开小发明
布列塔尼风情节	薄荷饼	布里多尼风情节
创世纪	Stvorenísveta	TheCreationoftheWorld
仓鼠鲍勃
魔盒与歌声	乐乐熊奇游记之魔盒与歌声
板牙东京竞速
弗兰克影片	弗兰克影片
神奇宝贝：皮卡丘的冰之大冒险
宇宙小子第三季
仙剑奇侠传	ChinesePaladin
兔斯基:爱之刺客
Dofus-Livre1:Julith	救世兵团（港）
乔瓦尼之岛	GiovanninoShima	Giovanni'sIsland
X特遣队	自杀小队	自杀突击队
怪物史瑞克（音乐剧）
横滨购物纪行	QuietCountryCafe#2
如何打造你的家庭影院	如何打造你的家庭影院
LittleBear
阿阿奇与西西帕克	阿痴与屎八	阿痴与傻逼
蝙蝠侠无极限：怪兽来袭	蝙蝠侠无极限：万圣惊魂	蝙蝠侠无限：万圣节浩劫
尼尔斯骑鹅旅行记	Nilsnofushiginatabi	TheWonderfulAdventuresofNils
芭比之间谍小队
朱利安国王万岁第一季	KingJulien
兄弟战争OVA：本命
BUSGAMER	ビズゲーマー
汤姆小雪人	汤姆小雪人
ふしぎ星の☆ふたご姫Gyu	不可思议星球的双子公主Gyu
全是怪物	AlloftheMonsters
新撰组异闻录铁	新撰組異聞PEACEMAKER	PeaceMakerKurogane
忍者神龟	忍者龟
风中之塔
爱如异形
棒球英豪在你离开之后	棒球英豪在你离开之后
瓢虫少女	MiraculousLadybug	レディバグ
高机动幻想（新结行军歌）	GunparadeMarch
网球王子剧场版：迹部的礼物	迹部的礼物
极乐世界	极乐星球大战
红孩儿大话火焰山	红孩儿：决战火焰山	FireBall:JourneytotheWest-TheSecretBehindtheFieryMount
皮克斯动画短片史	皮克斯短片史
地狱幼稚园
迷你乌贼娘	MiniSquidGirlShortStory	侵略乌贼娘特典OVA
龙珠Z剧场版2：世界最強的高手	世上最勇猛的人
翼·年代记第二季	羽翼年代记	翼·年代记第二季
贫乏姐妹物语	Binboushimaimonogatari	贫乏姐妹物语
骷髅13：女王蜂	骷髅13：女王蜂
欢乐满人间	欢乐满人间	玛丽.波平斯
售票亭	InTheTicketBooth
纳尼亚传奇1：狮子、女巫和魔衣橱	神奇的纳尼亚：狮子、女巫和衣橱	魔幻王国：狮子·女巫·魔衣橱
间谍少女组第一季	霹雳娇娃动漫版	TotallySpies
狂野情人	野性类恋人	Sexpistols
深夜食堂电影版	MidnightDiner
疫病犬	疫病犬
TheMakingofLongbird
好莱坞碗演奏会	万能指挥家
周末夜之猫
乐高的故事	TheLEGO®Story
乐高蝙蝠侠大战超人
贵妃醉酒	TheBanquetoftheConcubine
辛普森一家第十七季	辛普森一家	阿森一族	TheSimpsonsSeason17
ENDLESSNIGHT	日本アニメ見本市第28話	日本动画展览会第28话
希德尼娅的骑士剧场版
网球并不可笑嘛第四季	女高网球部第四季
圣子到-BOY	ハレルヤIIボーイ	HareluyaIIBoy
浮浪云	Haguregumo	WanderingCloud
小小羊蒂米第三季	快乐小羊吉米
史酷比2	史酷比2
怪医黑杰克	怪医秦博士	BLACKJACK
猪猪侠第一部：魔幻环保	猪猪侠第一部（魔幻环保）	魔幻猪猡纪
姐姐来了
猪猪侠5：积木世界里的童话	猪猪侠5积木世界里的童话
失落的一角	失落的一角遇见大圆满
魔法少女奈叶TheMOVIE1st	MagicalGirlLyricalNANOHATheMOVIE1st	魔法少女Lyrical奈叶TheMOVIE1st
暗黑刑警	巴黎2054
哆啦A梦：大雄的南极冰寒大冒险
妖精的尾巴：妖精们的合宿	男女合宿训练START	大骚乱大魔斗演武前的海边合宿
截稿日	便利贴动画
忧郁鼻	AnEmoNose
中华小子	ShaolinWuzang
恶搞之家第十三季
Who'sHungry
幽游白书夜叉的阴谋	幽游白书剧场版1993
天才小鱼郎RV	GranderMusashiRV	天才小鱼郎2
映画大师宫崎骏创作的秘密	宫崎骏：创作的秘密
圣斗士星矢冥王神话第1章	圣斗士星矢冥王神话
足球小将危险全日本Jr.	CaptainTsubasaMovie02-AttentionTheJapaneseJuniorSelection	足球小将之决战欧
足球小将奔向明日	CaptainTsubasaMovie03:Runtocatchthetomorrow	足球小将之反击欧洲
钟楼小精灵	午夜小精灵	钟楼精灵
红斑点	REDSPOT
精灵旅社3	鬼灵精怪大酒店3	尖叫旅社3
长江7号：超萌特攻队	超萌特攻队	长江7号动画大电影：超萌特攻队
创世纪传说：世界的彼方	骇客时空向着世界的另一端	.hack		BeyondtheWorld
创世纪	手塚治虫实验动画：创世纪	Souseiki
青蛙王国之冰冻大冒险	青蛙王国2	TheFrogKingdom2:Sub-ZeroMission
亚特兰蒂斯2：神秘的水晶	神秘的水晶	亚特兰蒂斯2：神秘的水晶
创造者	Dimiourgos
一张滑稽面孔的幽默姿态	Viccesarcokviccesfázisai
门后的秘密
新山海经
汉字的性格
无限地带23Ⅰ	Megazone23Part1
熊出没	熊出没第一部	BoonieBears
乐高星球大战：尤达编年史之幽灵克隆人
故作死亡的华人	TheDeathFeigningChinaman
一起来锻炼	TRAININGWITHHINAKO	一起来做俯卧撑
宠物小精灵：冥王龙与冰空的花束雪米	宠物小精灵之冥王龙与冰空的花束雪米	口袋妖怪冥王龙和冰空的花束
丧尸乐园	尸乐园	僵尸领地
旋风管家第四季
别抱我，我害怕4
线与色	一眨一瞎
西游记之孙悟空三打白骨精	西游记之大闹天宫续集	西游记之三打白骨精
梅子鸡之味	依恋，在生命最后八天	依恋在生命最后8天
知识老人
异形世界
恋爱情结	LovelyComplex	"LoveCom"
ウチュレイ	Uchurei
汉堡怪物
神奇独角马	小白角	独角小福星
鹿女
天与地	天堂与地狱
女皇之刃叛乱：圣女的烦闷～信仰之门、重开	女皇之刃叛乱OVA2
一起一起这里那里TV未放送的第13话
102真狗	102斑点狗	102只黑斑狗
大战千年虫
爆笑吸血鬼'99	MasterMosquiton'99	1999MasterofMosquiton
新蔷薇少女	RozenMaiden:Zurückspulen
棒球大联盟第四季	MAJORSeason4
传说中勇者的传说
镜头惊魂	KOWABON
拉格纳强袭天使	RagnastrikeAngels
和殿下一起	和殿下一起
科学家们
怪物史莱克4D	怪物史莱克-法尔奎德领主的鬼魂	史莱克·四度空间
红蓝大作战第一季
飞来电子狗	流浪机械狗
暴走恐怖故事第四季	暴走恐怖故事第四季
乡巴佬希尔一家的幸福生活第六季	一家之主第六季	山丘之王第六季
鲁邦三世：名为峰不二子的女人	LupinIII:TheWomanCalledFujikoMine
乡巴佬希尔一家的幸福生活第七季	一家之主第七季	山丘之王第七季
故事会	故事会
影子之王	影子国王
蚁人	蚁侠	Antman
少女天使	Angel'sFriends:TheMovie
乡巴佬希尔一家的幸福生活第十三季	一家之主第十三季	山丘之王第十三季
辛普森一家第十季	辛普森一家
要听爸爸的话男女8人夏物语	パパのいうことを聞きなさいOVA
鸦天狗卡布都	天下无敌超级忍者
钟馗伏魔：雪妖魔灵	ZhongKui:SnowGirlandtheDarkCrystal
翠星之加尔刚蒂亚OVA：废墟船团	翠星之加尔刚蒂亚第14话
GraffitiArea
不思议游戏OVA2：延续篇	不思议游戏OVA2延续篇	不可思议的游戏OVA2延续篇
新地道战2	新地道战2之父子奇兵
绝对可怜小孩THEUNLIMITED兵部京介	绝对可怜CHILDRENTHEUNLIMITED兵部京介	ZettaiKarenChildrenTheUnlimited
梦幻西游之化境飞升	梦幻西游2第二季
三国志：长江的燃烧	三国志第二部
犹太毒贩	圣辊
芭比之珍珠公主
血茶与红绳	血茶与红线	血茶与红绳
精灵俏女巫	TokimekiTonight	心跳晚上
树皮下的沉默	吠声下的沉默	TheSilenceBeneaththeBark
超级英雄的一天第三季
变形金刚：组合金刚之战	变形金刚：组合战争之战
老照片中的真相	老照片中的真相
鹿水瞳颜	Thesecretofeyes
MAR魔兵传奇	MAR魔法世界	魔兵传奇
坏未来	魔镜奇缘
玛雅历险记	拇指姬物语	拇指姑娘
女生爱女生	少女爱上了少女	Kashimashi:GirlMeetsGirl
特工次世代	BLAMEPrologue	PrologueofBlame
玉响完结篇第二部：响	玉响：毕业写真
宠物小精灵：梦幻与波导的勇者	宠物小精灵梦幻与波导的勇者鲁卡利欧	PokemonMovie8-LucarioandTheMyster
玉响完结篇第一部：芽	玉响：毕业写真
玉响毕业写真第3部：憧
穆罕默德：封印的使者	穆罕默德：最后的先知
太空熊猫英雄归来	SpacePandaHeroReturns	太空熊猫3
幸福小镇	HappyTown
终极蜘蛛侠第三季	蛛网勇士
伪恋OAD：兼职	酒后吐真言	伪恋OAD2	NisekoiOAD2:Change	Work
日在校园：情人节
自动机器人·铁臂阿童木	ASTROBOY鉄腕アトム	AstroBoytetsuwanatomu
吉吉小姐和蒙巴纳斯人	KikiofMontparnasse	蒙巴纳斯的吉吉
霍比特人	魔戒前传
假面骑士龙骑特别篇13骑士	KamenRiderRyukiSpecial:13Riders	MaskedRiderRyukiSpecial:13Riders
浪漫鼠德佩罗	双鼠记	大耳仔走天涯
特暴龙3D	特暴龙历险记	斑点：韩半岛的恐龙
哭泣杀神2风声鹤唳	泪眼煞星2	CryingFreeman2
婴儿城
鲁滨逊一家漂流记	家族鲁宾逊漂流记不可思议之岛的芙劳拉	新鲁宾逊漂流记
我的英雄学院第二季	我的英雄学院：雄英体育祭	Bokunoheroacademia
动画先锋-20-30年代德国动画艺术
其实我是	Iam
安奈的眼睛	找眼睛
益智游戏2	TheQuizShow2
HelloKitty
HelloKitty	凯蒂猫
你好,世界各国	Ragnarok	日本アニメ見本市第33話
乌托邦	Utopia
海贼王剧场版1：黄金岛冒险	OnePiece:TheMovie
悠哉日常大王OAD	冲绳之行
红气球	TheRedBalloon	红气球
呀小鬼之别惹小鬼	littledevils
驯龙赛手的起源
重金属
梦的家园
美鸟伴身边	美鸟日记
摩尔庄园3：魔幻列车大冒险	摩尔庄园大电影3魔幻列车大冒险	LegendOfTheMoles-TheMagicTrainAdventure
苍天之拳	苍天の拳	SoutennoKen
奥尔森三人帮之大难临头	奥尔森三人帮：大难临头	TheOlsenGanginDeeptrouble
英国一家，吃在日本	SushiandBeyond	EikokuIkke,NihonoTaberu
神雕侠侣
神的记事本	KamisamanoMemoChou	God'sNotebook
出包王女Darkness第二季	ToLove-RuDarkness2nd
海贼王TV版特别篇：父亲宏大的理想	海贼王TV版特别篇：父亲宏大的理想
主人的手	革命之手	TheHandofMaster
分身战士	Scryed	超能奇兵
玩偶游戏	小孩子的玩具	孩子们的游戏
铁子之旅	鉄子の旅
喜羊羊与灰太狼之衣橱大冒险	喜羊羊与灰太狼第十一季
小鸡不好惹
你答我呀	明白学堂系列之你答我呀
桃太郎传说	PEACHBOYLEGEND
菲菲的行业
龙珠剧场版：迈向最强之道	迈向最强之道
攻壳机动队AAA
奇怪的国家——日本
美人与巫师
茗记：2ndLife
网球并不可笑嘛第七季
小学老鼠
夏洛特特别篇（第14话）
追击者	TheChaser
草地上的午餐	BreakfastontheGrass
宇宙战舰大和号复活篇	UchūSenkanYamato:Fukkatsuhen	Yamato:Rebirth
轮盘记	石器时代	Rocks
小偷与鞋匠	阿拉伯骑士	两个阿拉伯骑士
浪客剑心：新京都篇	浪客剑心明治剑客浪漫谭新京都篇前篇
浪客剑心：新京都篇	浪客剑心明治剑客浪漫谭新京都篇后篇
机动战士高达逆A	TurnAGundam	逆A高达
仰望半月的夜空	仰望半月的天空	LookingupattheHalf-Moon
AngelBladePunish
一击杀虫小惠惠LEGACY
二重奏	二重唱
死侍	死侍：不死现身	恶棍英雄：死侍
潜行吧奈亚子OVA	袭来美少女邪神OVA
导盲犬	导盲犬
STRANGE+第二季	STRANGE+2期
长大尾巴的兔子
丑小鸭历险记
棋魂·通往北斗杯之路	棋魂~2004新春特别篇~通往北斗杯之路	棋魂·通往北斗杯之路
抢枕头
姨妈希尔达	AuntHilda
BenandHolly'sLittleKingdom
斯大林主义在波西米亚的终结	斯大林主义在波西米亚的终结	TheDeathofStalinisminBohemia
这就是僵尸吗地狱变	这个是僵尸吗第二季	这个是僵尸吗OfTheDead
一起来睡觉
黑色童话
海报狂想曲	InPoster
神经豆	吃饭睡觉打豆豆第三季
散华礼弥OAD2	散华礼弥TV未放送第13话
新哥斯拉	真・哥斯拉	正宗哥吉拉
反斗小王子	反斗小王子	邪留丸
少年泰坦第一季	少年超人队
剧场版吹响悠风号～欢迎来到北宇治高中吹奏乐部～	剧场版吹响上低音号～欢迎来到北宇治高中吹奏乐部～
电光超人古立特boysinventgreathero	日本アニメ見本市系列第9话	日本动画展览会第9话
精灵世纪	WizardCentury
红色浆果	红色浆果
鬼马小精灵第一季	TheSpooktacularNewAdventuresofCasper
TupTup
魔女宅急便真人版	MajonoTakkyūbin	Kiki'sDeliveryService
瑜伽熊记	ElshowdelosoYogi	Yogietsesamis
侦探歌剧少女福尔摩斯	TanteiOperaMirukīHōmuzu	TanteiOperaMilkyHolmes
英国恋物语艾玛
封神传奇之驱魔英雄	LegendofChineseTitans
白日末路	白日尽头
绯色恋	日和之恋	绯色恋
机动警察迷你版	PatlaborthemovieMiniPato	机动条子迷你版
麻雀酒店	SparrowsHotel
超音战士	Sonicsoldierborgman
爱神巧克力进行时	爱神巧克力	爱神巧克力ing
海绵宝宝：比基尼岛下的传奇	海绵宝宝：比基尼岛下的传奇
快要坏掉的八音盒剧场版
源氏物语
会长是女仆特别篇	会长是女仆大人TV未放送第27话	会长是女仆大人OVA
侦探歌剧少女福尔摩斯第2季
幻影丹尼第四季
未确认进行式OVA：看，那就是我们要下榻的旅馆哟	未确认进行式OVA
轻声密语	轻声密语
野孩子
刺客列传
麦克劳传奇第一季	麦克劳传奇第一季
小乌龟福兰克林	弗兰克林和奶奶的秘密
ProjectBlue地球SOS	蓝色计划地球SOS
京骚戏画
暴走恐怖故事第三季
极速蜗牛：飞越第二季
诚实预告第一季
排球女将	AttackonTomorrow	排球英雌
暗闇三太	くらやみさんた
金色琴弦2
Boop-Oop-A-Doop
Canardàl'orange,Le
牙-KIBA-
变身侠阿奔	外星传奇
钻石王牌	DianoAce
屋顶上的小飞人	KarlssonontheRoof
游戏王GX	Yu-Gi-OhGX
秘鲁大冒险	泰德，失落的探险	Tad,theLostExplorer
死后文未放送话	死后文第13话
结界师	Ketsukaishi
加菲猫和他的朋友们第二季	GarfilidWaUningDostliri
靴猫大冒险第一季	穿靴子的猫大冒险	穿靴子的猫历险记
高智能方程式赛车OVA3SAGA	高智能方程式赛车OVA3SAGA
驭龙少年	驱龙少年	DragonDrive
海月姬迷你小剧场上吧尼姑庵探险队
杰瑞和狮子
吸血鬼猎人D	BanpaiahantâD	VampireHunterD
清洁工汤姆	清洁工汤姆
辛普森一家第十八季	辛普森一家第十八季	阿森一族第十八季
金田一少年事件簿112雪影村杀人事件2	YukikageVillageMurderCase:File2
名侦探柯南特典：工藤新一迷之墙和黑色拉布犬事件	DetectiveConanMagicFile2	名侦探柯南剧场版第12弹特典
辛普森一家第九季	辛普森一家第九季
雪人与雪犬
Yurururu～日常篇～
太乙仙魔录之灵飞纪	太乙仙魔录
蚁哥正传	小蚁雄兵
哦超级小奶糖	OhSûpâMiruku-chan	OhSuperMilk-Chan	SuperMilkChan	TheSuperMilk-ChanShow	Vint
丁丁战猴王
菊次郎的夏天	Kikujirônonatsu	菊次郎的夏天
做一只鸟真不易	做一只鸟真不易
M.DGEIST	M.D.Geist
亡国的阿基德第4章：憎恨记忆	CodeGeass亡国的阿基德第四章「憎恨记忆」
战勇OVA：勇者被殴打
杀戮都市1	杀戮都市1
斗龙战士	数码宝贝在天朝
侦探歌剧少女福尔摩斯第3季	ふたりはミルキィホームズ	两个人是MilkyHolmes
辛普森一家第二十二季	阿森一族
如果我们遇见
布达佩斯大饭店	布达佩斯大酒店	欢迎来到布达佩斯大饭店
无法打开的黑与金的钥匙	黑与金之钥匙
开心汉堡店第三季
大利拉·德克和土耳其中尉
我的师父姜子牙	MasterJiangandtheSixKingdoms
诈欺游戏2	诈欺游戏2	LiarGame2
无限斯特拉托斯：世界清洗篇
白猩猩历险记	CopitodeNieve	Snowflake,legorilleblanc
龙珠Z特别篇：绝望的反抗仅存的超战士悟饭和特兰克斯	DragonBallZ:TheHistoryofTrunks
复活的融合悟空和贝吉塔	DragonBallZMovie12
哈姆太郎第三季
跳跳虎历险记	老虎的故事
疯狂动物城
