清姜街道	清姜街
棠香街道	棠香街
凤鸣街道	凤鸣街
陈塘庄街	陈塘庄街道
新华路街	新华路街道
杨市街	杨市街道
城东街道	城东街
七都街	七都街道
新兴街	新兴街道
大集街道	大集街
柏泉街	柏泉街道街道
滴水埠街	滴水埠街道
双井街道	双井街
霁虹街	霁虹街道
豫章街道	豫章街
北山街	北山街道
环山路街	环山路街道
紫荆街道	紫荆街
呼家楼街道	呼家楼街
仙林街	仙林街道
沙北街	沙北街道
新乐街道	新乐街
涨渡湖街	涨渡湖街道
天生街	天生街道
巴彦浩特新华街道	巴彦浩特新华街
城北路街道	城北路街
汤山街	汤山街道
横塘街道	横塘街
临江街道	临江街
鲍山街道	鲍山街
百安坝街	百安坝街道
辕门口街道	辕门口街
南街	南街街道
建设街道	建设街
城东街道	城东街
堡子里街	堡子里街道
辽源路街道	辽源路街
城子街	城子街道
长辛店街	长辛店街道
淳化街道	淳化街
和平路街道	和平路街
新兴街	新兴街道
金盆岭街道	金盆岭街
大龙湖街道	大龙湖街
新城街道	新城街
东北街街道	东北街
永兴街	永兴街道
蒲东街	蒲东街道
冶金街道	冶金街
石油新城街	石油新城街道
振兴街道	振兴街
张双楼街	张双楼街道
旭日街	旭日街道
舜华路街	舜华路街道
云山街	云山街道
河西街道	河西街
桥盟街道	桥盟街
少海街	少海街道
五四路街道	五四路街
西兰路街道	西兰路街
东升街道	东升街
晏家坪街	晏家坪街道
友好南路街	友好南路街道
宏业村街	宏业村街道
林校路街	林校路街道
河西街道	河西街
南海街	南海街道
济川街道	济川街
上渡街道	上渡街
王寨街道	王寨街
东风街	东风街道
松州街	松州街道
兴安街	兴安街道
城北街	城北街道
灵山卫街	灵山卫街道
新建北路街道	新建北路街
新青街	新青街道
新城街道	新城街
萨如拉街道	萨如拉街
琴断口街街道	琴断口街
建设路街道	建设路街
南湖街道	南湖街
临河街道	临河街
梅林街道	梅林街
桃源路街	桃源路街道
北镇街	北镇街道
永安街道	永安街
万宝桥街	万宝桥街道
联盟路街道	联盟路街
南白象街	南白象街道
渝州路街	渝州路街道
河西街道	河西街
都尉街道	都尉街
新安路街	新安路街道
城西街	城西街道
状元街道	状元街
工业路街	工业路街道
长江街	长江街道
天星桥街	天星桥街道
十六里河街道	十六里河街
鸿城街道	鸿城街
半汤街	半汤街道
兴隆街	兴隆街道
桂林街道	桂林街
南关街道	南关街
潭城街道	潭城街
学田街	学田街道
开元路街道	开元路街
汴河街道	汴河街
何寨街道	何寨街
东华街	东华街道
燕园街	燕园街道
罗家桥街	罗家桥街道
弋阳街	弋阳街道
和睦街	和睦街道
六道沟街	六道沟街道
城乡路街道	城乡路街
弦山街道	弦山街
枫林路街	枫林路街道
西菜园街道	西菜园街
华强北街道	华强北街
柳江街道	柳江街
中山路街	中山路街道
新城街道	新城街
新烟街道	新烟街
石洞子沟街道	石洞子沟街
三河尖街道	三河尖街
灶市街街道	灶市街
褡裢街道	褡裢街
斜土路街道	斜土路街
公园街道	公园街
广益街道	广益街
惠民街道	惠民街
东新街	东新街道
书院街街道	书院街
桥东街道	桥东街
敦仁街道	敦仁街
桃东街	桃东街道
云枫街道	云枫街
马窖街	马窖街道
交口街道	交口街
繁塔街道	繁塔街
南阳街道	南阳街
虎山街道	虎山街
大市口街道	大市口街
李珍街道	李珍街
南花园街	南花园街道
素龙街道	素龙街
郭溪街	郭溪街道
白云街道	白云街
东街	东街街道
桃花坞街道	桃花坞街
延安北路街道	延安北路街
东江街道	东江街
马家沟街	马家沟街道
河西街道	河西街
长延堡街道	长延堡街
新福街道	新福街
东大街街道	东大街
环北街	环北街道
丝绸路街道	丝绸路街
光华街	光华街道
林和街道	林和街
硖石街道	硖石街
下沙街道	下沙街
穿山街	穿山街道
中兴路街道	中兴路街
蒸湘街道	蒸湘街
弄弄坪街道	弄弄坪街
夷陵经济开发区街	夷陵经济开发区街道
轩岗街	轩岗街道
吉大街	吉大街道
朝阳区街道	朝阳区街
西泉街	西泉街道
华东街道	华东街
棣丰街道	棣丰街
雄州街	雄州街道
屺亭街道	屺亭街
东华街	东华街道
秀川街	秀川街道
全宁街道	全宁街
红云街道	红云街
长水街道	长水街
江都路街道	江都路街
凤凰山街	凤凰山街道
新枫街道	新枫街
北城街道	北城街
凯旋街道	凯旋街
兴岗街道	兴岗街
鼓楼街	鼓楼街道
三中街	三中街街道
荆山街道	荆山街
大王庄街道	大王庄街
新厂街	新厂街道
新生街道	新生街
灵溪街	灵溪街道
北山街	北山街道
于河街道	于河街
山南街	山南街道
火磨街道	火磨街
卧里屯街	卧里屯街道
金都街道	金都街
双桥子街	双桥子街道
南营街道	南营街
锦屏街	锦屏街道
辛店街道	辛店街
喀赞其街	喀赞其街道
演武街	演武街道
东洲街道	东洲街
中山南路街道	中山南路街
郭杜街道	郭杜街
龙泉街	龙泉街道
交口街道	交口街
达来胡硕街道	达来胡硕街
北市场街道	北市场街
吴林街道	吴林街
永安路街	永安路街道
富春街道	富春街
雨湖路街	雨湖路街道
月牙河街	月牙河街道
凌西街道	凌西街
秦陵街道	秦陵街
南大街街道	南大街
娄门街	娄门街道
桦木林街	桦木林街道
北园街道	北园街
桥西街道	桥西街
南寒街道	南寒街
英达街	英达街道
象园街道	象园街
唐家墩街街道	唐家墩街
前所街道	前所街
裕南街街道	裕南街
岭东街道	岭东街
曲溪街	曲溪街道
榆山街道	榆山街
故县街道	故县街
湾里街道	湾里街
新城街道	新城街
大渡口街道	大渡口街
联纺西街	联纺西街道
北湖街道	北湖街
天通苑南街道	天通苑南街
沙河街道	沙河街
东山街	东山街道
北海路街	北海路街道
凤凰街	凤凰街道
青云街道	青云街
头屯河街道	头屯河街
五里街道	五里街
张新街道	张新街
麓谷街道	麓谷街
方村街	方村街道
涵东街道	涵东街
新山村街道	新山村街
纬四街道	纬四街
圭塘街道	圭塘街
石牌街	石牌街道
二里半街道	二里半街
望水台街道	望水台街
王瓜店街道	王瓜店街
文化街道	文化街
淮河路街	淮河路街道
自强路街	自强路街道
文峰街	文峰街道
东安街	东安街道
名山街道	名山街
东直门街	东直门街道
花园路街	花园路街道
小板桥街	小板桥街道
经二路街	经二路街道
荣市街道	荣市街
公园街道	公园街
窑湾街	窑湾街道
济北街	济北街道
西溪坪街道	西溪坪街
六村堡街	六村堡街道
城东街道	城东街
城区街道	城区街
王串场街	王串场街道
松城街	松城街道
凫山街道	凫山街
五星街道	五星街
海滨街	海滨街道
山河街道	山河街
潘火街道	潘火街
中洲路街	中洲路街道
龙岗街	龙岗街道
榆树街道	榆树街
大台街	大台街道
五山街	五山街道
横梁街道	横梁街
中心街	中心街道
宁新街道	宁新街
劲松街道	劲松街
团结街	团结街道
长城中路街	长城中路街道
丽岙街道	丽岙街
上杭路街道	上杭路街
城西街	城西街道
党家街道	党家街
诗书街道	诗书街
鲸园街	鲸园街道
中华街道	中华街
姜谭街道	姜谭街
朝阳街	朝阳街道
城东街道	城东街
南滨街	南滨街道
凤山街	凤山街道
北街	北街街道
赞善街道	赞善街
彰东街	彰东街道
月牙湖街	月牙湖街道
西陵街道	西陵街
黄泥塘街	黄泥塘街道
翠湖街道	翠湖街
老站街	老站街道
河埒街道	河埒街
益都街道	益都街
中山街道	中山街
明珠街	明珠街道
学院路街道	学院路街
正阳街	正阳街道
含增长钢街道	含增长钢街
招宝山街	招宝山街道
铁西路街	铁西路街道
连云街道	连云街
昆仑路街道	昆仑路街
丹西街	丹西街道
戚墅堰街	戚墅堰街道
西湖街道	西湖街
长庆路街道	长庆路街
蕺山街道	蕺山街
三茅街道	三茅街
南城街道	南城街
富强路街	富强路街道
东山街	东山街道
禄口街道	禄口街
嵩山路街	嵩山路街道
五桥街道	五桥街
城西路街道	城西路街
苍龙街道	苍龙街
东站街	东站街道
舍利塔街道	舍利塔街
大河中路街	大河中路街道
赫山街道	赫山街
东城街	东城街道
珠池街道	珠池街
章安街道	章安街
乌龙街	乌龙街道
明仁街道	明仁街
黄贝街道	黄贝街
沙塘湾街道	沙塘湾街
振兴街道	振兴街
新农街	新农街道
民主街道	民主街
潘家园街道	潘家园街
莲花湖街	莲花湖街道
王家沟街道	王家沟街
临洮街街道	临洮街
顾里木图街道	顾里木图街
建政街道	建政街
水东街道	水东街
龙河街道	龙河街
天坛街道	天坛街
同安街	同安街道
明光路街道	明光路街
金杨新村街	金杨新村街道
建北街道	建北街
引镇街道	引镇街
天水郡街	天水郡街道
蒲城街道	蒲城街
五星街道	五星街
友谊大街	友谊大街街道
杨庄街	杨庄街道
栎阳街道	栎阳街
桃园路街	桃园路街道
西湾子街	西湾子街道
丹东街道	丹东街
蔬园乡街道	蔬园乡街
六台街道	六台街
紫阳街	紫阳街道
城北街	城北街道
金山路街	金山路街道
岭东街道	岭东街
西陂街道	西陂街
凉城新村街道	凉城新村街
红树街道	红树街
老城街	老城街道
殷行街道	殷行街
附城街	附城街道
七里塘街道	七里塘街
东城街	东城街道
城镇街	城镇街道
观海路街	观海路街道
仁皇山街	仁皇山街道
北海街	北海街道
兴城街	兴城街道
蔡都街道	蔡都街
江南街	江南街道
金城江街	金城江街道
宁远街道	宁远街
龙塔街道	龙塔街
永吉街道	永吉街
玉祁街	玉祁街道
千峰街道	千峰街
乐安街道	乐安街
东新街	东新街道
佟沟街	佟沟街道
新湾街道	新湾街
平南街道	平南街
良渚街道	良渚街
水部街	水部街道
汤河子街	汤河子街道
铜都街道	铜都街
中街街道	中街
新华路街	新华路街道
北关街道	北关街
龙泉街	龙泉街道
围子街	围子街道
北京路街	北京路街道
喀什东路街	喀什东路街道
千金街道	千金街
里则街	里则街道
北大街街道	北大街
松洲街道	松洲街
龙泉街	龙泉街道
上郡路街道	上郡路街
秀容街道	秀容街
大智街	大智街街道
三岔路街道	三岔路街
南辛庄街道	南辛庄街
友谊街道	友谊街
东关街	东关街街道
西岗街	西岗街道
永红桥街	永红桥街道
财神庙街	财神庙街道
竟陵街道	竟陵街
新城街道	新城街
淦阳街道	淦阳街
只楚街	只楚街道
前山街道	前山街
馀家湖街	馀家湖街道
谢家集街道	谢家集街
扬子津街	扬子津街道
三里桥街道	三里桥街
骅东街道	骅东街
王纲街道	王纲街
五星街街道	五星街
三江街	三江街道
凤阳街道	凤阳街
三埠街道	三埠街
棠下街道	棠下街
人民街	人民街街道
东城街	东城街道
万宝街道	万宝街
学院路街道	学院路街
光明路街道	光明路街
方圆街	方圆街道
张庄街	张庄街道
光明街	光明街道
杏花村街	杏花村街道
共济街	共济街道
滨北街道	滨北街
横溪街	横溪街道
东许街	东许街道
马金铺街	马金铺街道
南寨街	南寨街道
小街	小街街道
水上街道	水上街
隆中街道	隆中街
集贤街道	集贤街
峒河街	峒河街道
裕兴街道	裕兴街
城东街道	城东街
祥和街道	祥和街
五三街	五三街道
灯塔街道	灯塔街
富锋街道	富锋街
平安西部街道	平安西部街
汤池街	汤池街道
西屯街	西屯街道
新乐街道	新乐街
小雪街道	小雪街
卡子湾街道	卡子湾街
民胜街道	民胜街
凌空街道	凌空街
北湖街街道	北湖街
湖北路街道	湖北路街
南岗街	南岗街道
海拉尔西路街	海拉尔西路街道
浏正街	浏正街街道
北三家子街	北三家子街道
水师营街	水师营街道
友谊路街道	友谊路街
五块石街道	五块石街
五图街	五图街道
道北街道	道北街
香花桥街	香花桥街道
万盛街道	万盛街
瞿溪街道	瞿溪街
王家河街道	王家河街
崇安街	崇安街道
法相岩街	法相岩街道
和平街道	和平街
列西街	列西街道
潮海街	潮海街道
五里堆街道	五里堆街
花园路街	花园路街道
奋斗街道	奋斗街
嘉莲街道	嘉莲街
乌伊岭街道	乌伊岭街
光亚街道	光亚街
醴泉街	醴泉街道
安阜街道	安阜街
火车南站街道	火车南站街
卧龙街	卧龙街道
东岗西路街道	东岗西路街
留营街道	留营街
六号街道	六号街
东社街	东社街道
新源街	新源道街道
西露天街	西露天街道
前海街道	前海街
涵西街道	涵西街
蓼城街	蓼城街道
香蜜湖街	香蜜湖街道
桃山街道	桃山街
昌盛街道	昌盛街
五里界街	五里界街道
汤陵街道	汤陵街
城东街道	城东街
梧桐街	梧桐街道
漓东街	漓东街道
南星街	南星街道
东大街街道	东大街
北坛街道	北坛街
新城桥街道	新城桥街
徐福街道	徐福街
秋长街道	秋长街
新华街道	新华街
磐石街道	磐石街
宁津街道	宁津街
彩北街	彩北街道
常州道街道	常州街
城东街道	城东街
荔城街	荔城街道
红雁街道	红雁街
红花街道	红花街
平山街道	平山街
泊水街	泊水街道
茨坪街	茨坪街道
南街	南街街道
朗霞街道	朗霞街
平潭街	平潭街街道
北城区街	北城区街道
东兴街道	东兴街
中山西路街道	中山西路街
新北区街道	新北区街
石井街	石井街道
园岭街	园岭街道
新民街道	新民街
南王街道	南王街
龙东街道	龙东街
南城街道	南城街
二七街道	二七街
州城街	州城街道
满堂街道	满堂街
头道桥街道	头道桥街
马宫街道	马宫街
普东街道	普东街
三山岛街	三山岛街道
东鲁街	东鲁街道
湖东街道	湖东街
永安台街	永安台街道
肖坝街道	肖坝街
西南隅街	西南隅街道
和平路街道	和平路街
新发街道	新发街
柏城街道	柏城街
正大街道	正大街
乔屯街道	乔屯街
北城街道	北城街
钓鱼城街	钓鱼城街道
杜桥街道	杜桥街
斗南街	斗南街道
尚志街道	尚志街
虎丘街	虎丘街道
东光街	东光街道
西村街	西村街道
小山街	小山街道
兰山街道	兰山街
三桥街道	三桥街
九街	九道街道
南城街道	南城街
北街	北街街道
振林街	振林街道
中曹司街道	中曹司街
平政路街	平政路街道
东铁匠营街道	东铁匠营街
中央门街	中央门街道
坊安街道	坊安街
横荷街道	横荷街
马三家街	马三家街道
谷里街道	谷里街
城郊街道	城郊街
都林街道	都林街
巴音门克街道	巴音门克街
径河街道	径河街
金龙街	金龙街道
台西街道	台西街
鲤城街	鲤城街道
光明街	光明街道
宝光街道	宝光街
浮山新区街道	浮山新区街
赵家屯街	赵家屯街道
古城街	古城街道
宜城街	宜城街道
休门街道	休门街
马群街道	马群街
南城街道	南城街
北岙街	北岙街道
建设街道	建设街
兀术街	兀术街街道
园林街道	园林街
正东路街	正东路街道
市中街道	市中街
珠斯花街	珠斯花街道
东城街	东城街道
团结街	团结街道
刘山街道	刘山街
湖墅街道	湖墅街
荣华街	荣华街街道
宝华街道	宝华街
石桥街	石桥街道
胜利桥街道	胜利桥街
优越路街	优越路街道
钢山街道	钢山街
团结湖街	团结湖街道
龙港街	龙港街道
城区街道	城区街
文化街道	文化街
永清县街道	永清县街
民生街	民生街道
两市塘街道	两市塘街
华昌街道	华昌街
金海街	金海街道
宏路街	宏路街道
北城街道	北城街
骆驼街道	骆驼街
兴东街道	兴东街
登峰街道	登峰街
鸳鸯街道	鸳鸯街
环岭街道	环岭街
滦镇街	滦镇街道
朝阳洲街道	朝阳洲街
汤河街	汤河街街道
天长街	天长街道
河东街	河东街道
新发街道	新发街
永丰街道	永丰街
地磅街	地磅街道
城墙街道	城墙街
平庄城区街道	平庄城区街
呼伦街	呼伦街道
兴隆街	兴隆街道
金阊街道	金阊街
上海路街	上海路街道
下元街	下元街道
北苑街	北苑街道
裕西街道	裕西街
广富林街	广富林街道
奇家岭街	奇家岭街道
乌昌路街道	乌昌路街
煤矿街道	煤矿街
大有街	大有街道
六顺街	六顺街道
杨村街道	杨村街
军山街道	军山街
枫桥湖街道	枫桥湖街
昌华街	昌华街道
冯营街道	冯营街
长青街道	长青街
城南街	城南街道
白清街	白清街道
宝东街道	宝东街
南苑街	南苑街道
北极街	北极街道
栏杆街道	栏杆街
龙泉街	龙泉街道
双桥街道	双桥街
市中街道	市中街
百花洲街	百花洲街道
台东街	台东街道
晏家街道	晏家街
杨林街道	杨林街
向阳街道	向阳街
肖家园街	肖家园街道
石围塘街道	石围塘街
永清路街道	永清路街
科苑街	科苑街道
辽东街道	辽东街
打浦桥街	打浦桥街道
江浦街道	江浦街
苗圃街道	苗圃街
古城街	古城街道
鼎山街道	鼎山街
华舍街道	华舍街
泺源街道	泺源街
马官桥街	马官桥街道
元岗街道	元岗街
盐龙街道	盐龙街
钟村街	钟村街道
陇海路街	陇海路街道
中山东路街道	中山东路街
望城街道	望城街
安宁街	安宁街道
仙城街	仙城街道
四鹤街	四鹤街道
夜明珠街道	夜明珠街
新开铺街道	新开铺街
工人村街道	工人村街
研和街道	研和街
新塘街道	新塘街
龙池街道	龙池街
三街	三街街道
新市区街	新市区街道
白马山街道	白马山街
工人新村街道	工人新村街
五一路街	五一路街道
锦林街	锦林街道
前进街	前进街街道
团山街道	团山街
程桥街	程桥街道
丁字沽街	丁字沽街道
凤岗街道	凤岗街
淮滨街	淮滨街道
文峰街	文峰街道
北海街	北海街道
赤马港街道	赤马港街
下站街道	下站街
吴家堡街道	吴家堡街
第三街	第三街道
桂林街道	桂林街
中街街道	中街
沟南街	沟南街道
江南街	江南街道
朝阳街	朝阳街道
蒙阴街道	蒙阴街
茄子溪街道	茄子溪街
棉城街	棉城街道
营盘街道	营盘街
廿里堡街道	廿里堡街
延安中路街	延安中路街道
联盟街道	联盟街
望湖街道	望湖街
顺河街	顺河街街道
城东街道	城东街
凤岗街道	凤岗街
东湖街	东湖街道
南桥街道	南桥街
赤溪街道	赤溪街
湖西街	湖西街道
吴宁街	吴宁街道
化成街	化成街道
海山街	海山街道
坝陵桥街	坝陵桥街道
伊犁河路街道	伊犁河路街
幸福街道	幸福街
刘桥街	刘桥街道
柳城街道	柳城街
南盛街道	南盛街
中北街道	中北街
金顶街	金顶街街道
和平路街道	和平路街
西卓子山街道	西卓子山街
夫子庙街道	夫子庙街
七顶山街	七顶山街道
李营街道	李营街
安家街	安家街道
雨花新村街道	雨花新村街
南门关街	南门关街道
武圣街道	武圣街
龙潭街道	龙潭街
新塘街道	新塘街
百间房街	百间房街道
硕放街道	硕放街
南口街道	南口街
新合街道	新合街
华林新村街道	华林新村街
殿前街道	殿前街
四里村街道	四里村街
街里街道	街里街
新华街道	新华街
万春街道	万春街
弹子石街道	弹子石街
长乐坊街	长乐坊街道
和平街道	和平街
英巴扎街	英巴扎街道
红庙子街	红庙子街道
三家店街道	三家店街
华乐街	华乐街道
百城街	百城街道
华家街	华家街道
广场街	广场街街道
甘家口街	甘家口街道
府山街	府山街道
卞庄街道	卞庄街
登峰街道	登峰街
利国街道	利国街
京广路街道	京广路街
方庙街	方庙街道
吉泰街道	吉泰街
鸥汀街道	鸥汀街
西航街道	西航街
三宝街道	三宝街
赤城街	赤城街道
北关街道	北关街
沙湾街	沙湾街道
北宅街道	北宅街
蓬莱阁街道	蓬莱阁街
仙人庄街道	仙人庄街
古南街道	古南街
北苑街	北苑街道
青阳街	青阳街道
石桥子街	石桥子街道
石仔岭街道	石仔岭街
郯城街道	郯城街
陈食街道	陈食街
凤凰街	凤凰街道
骊城街道	骊城街
鱼沃街道	鱼沃街
北下街	北下街街道
王莽街	王莽街道
太行街	太行街道
江口街道	江口街
火车站街	火车站街街道
茨菇塘街	茨菇塘街道
水西门街	水西门街道
辛寺街街道	辛寺街
中兴街道	中兴街
东四街道	东四街
爱路街	爱路街道
爱民东道街道	爱民东街
中关村街	中关村街道
赵家街道	赵家街
二戈寨街	二戈寨街道
丰宁街道	丰宁街
民主街道	民主街
王滨街道	王滨街
大埠桥街道	大埠桥街
泉口街道	泉口街
天山路街	天山路街道
煤海街道	煤海街
孙渡街	孙渡街道
杨金路街	杨金路街道
联纺东街道	联纺东街
铭功路街道	铭功路街
明廉街道	明廉街
新华南路街道	新华南路街
古城街	古城街道
平凉路街道	平凉路街
拱星墩街	拱星墩街道
八街	八道街道
亮子河街	亮子河街道
高塘岭街	高塘岭街道
汇丰街	汇丰街道
郭家坳街街道	郭家坳街
城西街	城西街道
通惠街道	通惠街
卡布其街道	卡布其街
列东街道	列东街
南翼街道	南翼街
福安街	福安街道
井龙街道	井龙街
中兴街道	中兴街
大黄山街道	大黄山街
团山街道	团山街
林机街道	林机街
城区街道	城区街
府城街	府城街道
鼓楼街	鼓楼街道
英雄中路街道	英雄中路街
潍坊新村街道	潍坊新村街
礼乐街	礼乐街道
九里山街道	九里山街
陈江街道	陈江街
永平街道	永平街
陵东街道	陵东街
南湖街道	南湖街
江南街	江南街道
东城街	东城街道
高都街	高都街道
富强街道	富强街
高新路街道	高新路街
铜城街	铜城街道
新滩镇街	新滩镇街道
素社街道	素社街
临江街道	临江街
东风路街	东风路街道
老街	老街街道
鼓浪屿街道	鼓浪屿街
东海街道	东海街
秀英街道	秀英街
红石崖街	红石崖街道
民权街街道	民权街
林源镇街道	林源镇街
吴井街道	吴井街
兴谷街道	兴谷街
般阳路街道	般阳路街
金马街道	金马街
仁德街	仁德街道
健康路街道	健康路街
摩梭河街	摩梭河街道
九里街道	九里街
平罗街道	平罗街
友好街	友好街道
东街	东街街道
下郭街	下郭街道
中山街道	中山街
曙光路街	曙光路街道
县街	县街街道
向阳里街	向阳里街道
临江街道	临江街
向阳街道	向阳街
双照街道	双照街
大李家街道	大李家街
南长街	南长街道
天泰寺街	天泰寺街道
一元街街道	一元街
兴田街	兴田街道
杨陵街	杨陵街道
南广街	南广街道
玄武湖街道	玄武湖街
前进街	前进街道
大港街	大港街道
南湖街道	南湖街
锦秋街道	锦秋街
江头街道	江头街
东镇街道	东镇街
海秀街	海秀街道
北山街	北山街道
六道口街道	六道口街
龙洞堡街道	龙洞堡街
朝阳街	朝阳街道
青年街	青年街道
建设街道	建设街
张村街道	张村街
西安路街	西安路街道
城西街	城西街道
新建街	新建街道
六里屯街道	六里屯街
沿江街	沿江街道
唐家庄街道	唐家庄街
文家街道	文家街
窑店街	窑店街道
沙园街道	沙园街
水泥路街	水泥路街道
城关街道	城关街
临城街	临城街道
香河园街	香河园街道
工区街	工区街道
西潞街道	西潞街
丹阳街道	丹阳街
金惠街道	金惠街
泉西街	泉西街道
长城街道	长城街
大街	大街街道
凤凰台街	凤凰台街道
闸弄口街道	闸弄口街
高照街道	高照街
一马路街	一马路街道
人民路街道	人民路街
鳌峰街	鳌峰街道
朝阳路街	朝阳路街道
龙江街	龙江街道
学苑街道	学苑街
汉华街	汉华街道
东北塘街	东北塘街道
河庄街	河庄街道
祖庙街道	祖庙街
葛布街	葛布街道
桃园街	桃园街道
洋中街	洋中街道
汪家拐街	汪家拐街道
和平街道	和平街
马王堆街	马王堆街道
上西街道	上西街
工农街道	工农街
西曲街道	西曲街
人和街	人和街道
历山街道	历山街
汉冶街	汉冶街道
马桥子街	马桥子街道
长白新村街道	长白新村街
荷城街道	荷城街
河西街道	河西街
丛台西街	丛台西街道
泰山路街	泰山路街道
郭家沱街道	郭家沱街
江溪街道	江溪街
仓前街	仓前街道
黄桥街道	黄桥街
合阳城街道	合阳城街
火炬开发区街道	火炬开发区街
邵公庄街	邵公庄街道
昌元街道	昌元街
湖南街	湖南街道
昱西街	昱西街道
江海街	江海街道
太行街	太行街道
珠海路街道	珠海路街
满春街	满春街街道
霍林街道	霍林街
城东街道	城东街
大庆街道	大庆街
汾河街道	汾河街
两岛街道	两岛街
东门街	东门街道
卫北街道	卫北街
响石岭街	响石岭街道
中兴路街道	中兴路街
金门路街道	金门路街
东城街	东城街道
娲城街道	娲城街
南关街道	南关街
海滨街	海滨街道
双环村街	双环村街道
徐家营街道	徐家营街
董家窑街	董家窑街道
下渡街道	下渡街
河南街道	河南街
云塘街道	云塘街
苏苑街	苏苑街道
大坪街道	大坪街
桥南街道	桥南街
银古路街	银古路街道
西三旗街	西三旗街道
湛山街道	湛山街
东柳街道	东柳街
大沟街	大沟街道
振华路街道	振华路街
松华街	松华街道
桦林橡胶厂街	桦林橡胶厂街道
宝力根街	宝力根街道
福镇街	福镇街道
向阳街道	向阳街
东村街	东村街道
黄甲街道	黄甲街
大安街	大安街道
西航港街道	西航港街
军地坪街	军地坪街道
沙河街道	沙河街
迎宾路街	迎宾路街道
福兴街道	福兴街
双丰街	双丰街道
坊城街道	坊城街
城南街	城南街道
和平街道	和平街
大山坪街道	大山坪街
北城区街	北城区街道
哈西街道	哈西街
市东街	市东街道
白塔岭街	白塔岭街道
堤口路街道	堤口路街
大榭街道	大榭街
华中路街道	华中路街
中山门街道	中山门街
桂林路街	桂林路街道
龙华山街道	龙华山街
沙井街道	沙井街
草堂街道	草堂街
机场街	机场街道
真武山街	真武山街道
金华街	金华街道
稷下街道	稷下街
高新街道	高新街
颍川街	颍川街道
滘头
环秀街	环秀街道
华凤街道	华凤街
石炭井街	石炭井街道
龙溪街道	龙溪街
八一路街	八一路街道
富乐街	富乐街道
台北街	台北街街道
霍营街	霍营街道
黄茶岭街	黄茶岭街道
军城街道	军城街
福城街道	福城街
团结街	团结街道
飞云街道	飞云街
小店街	小店街道
紫来街	紫来街道
金花桥街	金花桥街道
金陵街道	金陵街
松岗街	松岗街道
佳西街道	佳西街
黄山街	黄山街道
敦化路街	敦化路街道
天宫殿街道	天宫殿街
解放碑街	解放碑街道
龙翔街道	龙翔街
襄阳街	襄阳街街道
九龙街道	九龙街
太和街	太和街道
马家堡街道	马家堡街
友谊街道	友谊街
雁北街	雁北街道
桥林街道	桥林街
中华大街	中华大街街道
斜口街道	斜口街
崇文街	崇文街道
左岭街道	左岭街
晏北街	晏北街道
卧龙街	卧龙街道
石臼街	石臼街道
洪山坡街	洪山坡街道
朔方路街	朔方路街道
龙凤街道	龙凤街
土门街	土门街道
新安街道	新安街
团结路街道	团结路街
秋滨街道	秋滨街
学府街道	学府街
华山街道	华山街
城东街道	城东街
李村街道	李村街
靖城街	靖城街道
闸口街道	闸口街
南街	南街街道
梅里斯街道	梅里斯街
浓洄街	浓洄街道
爱山街	爱山街道
洪门街道	洪门街
白石街	白石街道
人民路街道	人民路街
香港中路街道	香港中路街
城区街道	城区街
人和街	人和街道
宁化街	宁化街道
文化街道	文化街
石泉路街道	石泉路街
白狐沟街道	白狐沟街
梧村街	梧村街道
富国街道	富国街
钓台街道	钓台街
新城街道	新城街
瑞景街	瑞景街道
北林路街	北林路街道
舜耕街道	舜耕街
金花街	金花街道
北港街	北港街道
新义街	新义街街道
东公园街	东公园街道
金鸭街道	金鸭街
大雁塔街	大雁塔街道
信安街	信安街道
赤壁街	赤壁街道
千佛山街道	千佛山街
粮道街道	粮街
北城街道	北城街
三江街	三江街道
夏港街	夏港街道
汉城街	汉城街道
二台子街	二台子街道
东山街	东山街道
来凤街道	来凤街
易家街道	易家街
田村街道	田村街
古江巴格街	古江巴格街道
苑东街道	苑东街
朱里街道	朱里街
洪塘街道	洪塘街
先锋街道	先锋街
华苑街道	华苑街
望春门街	望春门街道
秦灶街	秦灶街道
底张街道	底张街
凤凰山街	凤凰山街道
光化街	光化街道
建设街道	建设街
日新街道	日新街
青田街道	青田街
北街	北街街道
地直街	地直街道
新安街道	新安街
惠阳街道	惠阳街
高升街	高升街街道
吴家营街	吴家营街道
马坊街道	马坊街
钟楼街道	钟楼街
城中街道	城中街
黄花街	黄花街道
十字街	十字街街道
六榕街	六榕街道
仓前街	仓前街道
黄山街	黄山街道
龙泉街	龙泉街道
山坡街	山坡街道
新江街道	新江街
五一路街	五一路街道
凤林街道	凤林街
东郊街道	东郊街
沙河街道	沙河街
谈固街	谈固街道
上马街	上马街道
学院街道	学院街
何楼街道	何楼街
南苑街	南苑街道
万福街	万福街道
桥头街道	桥头街
挖金湾街道	挖金湾街
王家街道	王家街
林盛街道	林盛街
月河街道	月河街
福海街	福海街道
增江街	增江街道
希日塔拉街道	希日塔拉街
通江街道	通江街
红岗街道	红岗街
望春街	望春街道
市西街道	市西街
大石街道	大石街
兴隆路街	兴隆路街道
东关街道	东关街
广益街道	广益街
屯兰街	屯兰街道
白山路街	白山路街道
梁才街道	梁才街
八里堡街道	八里堡街
延安街道	延安街
英城街	英城街道
市府东路街道	市府东路街
龙湖街	龙湖街道
亚瓦格街	亚瓦格街道
城南路街道	城南路街
库伦街道	库伦街
东门街	东门街道
红山街道	红山街
北城街道	北城街
裕溪口街	裕溪口街道
五星街道	五星街
黄土坑街道	黄土坑街
西罗园街	西罗园街道
正岔街	正岔街道
望江路街	望江路街道
大宁路街	大宁路街道
刘房子街	刘房子街道
长江路街	长江路街道
南关街道	南关街
体育馆街道	体育馆街
大斗沟街	大斗沟街道
棠景街道	棠景街
七里湖街	七里湖街道
神堂沟街道	神堂沟街
凌安街	凌安街道
唐宫路街道	唐宫路街
荔联街道	荔联街
庄桥街道	庄桥街
中马街道	中马街
拉法街道	拉法街
团结街	团结街道
大弯街	大弯街道
双山街	双山街道
建宁街道	建宁街
北苑街	北苑街道
杜儿坪街	杜儿坪街道
保和街道	保和街
古槐街	古槐街道
琼科瑞克街道	琼科瑞克街
河沥街	河沥街道
酒泉路街道	酒泉路街
解放路街道	解放路街
汊河街	汊河街道
东盛街道	东盛街
索河街	索河街道
昭阳街	昭阳街道
北城街道	北城街
大观园街	大观园街道
云亭街道	云亭街
凤凰路街	凤凰路街道
自强街	自强街道
寺坡街道	寺坡街
桃源街道	桃源街
群英街	群英街道
龙岗街	龙岗街道
西门里街	西门里街道
市西街道	市西街
城南街	城南街道
甘棠街道	甘棠街
龙山街	龙山街道
瑞州街	瑞州街道
明仁街道	明仁街
昌国街道	昌国街
龙丰街道	龙丰街
朝阳街	朝阳街道
李家街	李家街道
南湖街道	南湖街
晒口街	晒口街道
翠香街道	翠香街
寸滩街道	寸滩街
金桥路街	金桥路街道
凤凰台街	凤凰台街道
周棚街	周棚街道
百家村街	百家村街道
栗雨街	栗雨街道
会昌街	会昌街道
红旗桥街道	红旗桥街
银雀山街道	银雀山街
制锦市街道	制锦市街
南门街	南门街道
幸福路街道	幸福路街
清风街	清风街街道
真如镇
长虹街	长虹街道
北太平庄街	北太平庄街道
南城街道	南城街
城西街	城西街道
岳麓街	岳麓街道
文化街道	文化街
南闸街	南闸街道
洗马路街	洗马路街道
凤凰街	凤凰街道
豫园街	豫园街道
永安街道	永安街
新成路街道	新成路街
亚父街道	亚父街
新城街道	新城街
江南街	江南街道
博济桥街	博济桥街道
镇江寺街	镇江寺街道
西南街	西南街道
新华街道	新华街
南川东路街	南川东路街道
新富街	新富街道
龙泉街	龙泉街道
江南街	江南街道
辉山街	辉山街道
南湖街道	南湖街
雪宫街	雪宫街道
武原街	武原街道
箕子台街	箕子台街道
天坛街道	天坛街
天府街道	天府街
南津渡街	南津渡街道
人和街	人和街道
城子坦街	城子坦街道
龙山街	龙山街道
桂城街道	桂城街
杏滨街	杏滨街道
西南岗街	西南岗街道
瘦西湖街	瘦西湖街道
东站街	东站街道
百里奚街	百里奚街道
南津路街道	南津路街
广州路街道	广州路街
龙华街	龙华街道
西宾街道	西宾街
筼筜街道	筼筜街
清凉寺街	清凉寺街道
城阳街道	城阳街
南坪街道	南坪街
伏龙坪街道	伏龙坪街
小市街道	小市街
岐山街道	岐山街
五五新镇街道	五五新镇街
中城街道	中城街
北京西路街	北京西路街道
少林街	少林街道
建工街道	建工街
城南街	城南街道
书院街街道	书院街
马脊梁街	马脊梁街道
城南街	城南街道
汝河路街	汝河路街道
古城街	古城街道
张庄路街	张庄路街道
金贸街道	金贸街
开元街道	开元街
黄河路街道	黄河路街
文化路街道	文化路街
太华路街道	太华路街
银河南路街	银河南路街道
孙村街	孙村街道
大庸桥街道	大庸桥街
涧河街道	涧河街
青菱街道	青菱街
六角亭街道	六角亭街
南海街	南海街道
工农路街道	工农路街
滨河街道	滨河街
龙王塘街	龙王塘街道
三永街道	三永街
周家渡街	周家渡街道
小港街	小港街道
东三街	东三街道
光武街	光武街道
北城街道	北城街
富岭街道	富岭街
长洲街道	长洲街
桃园街	桃园街道
仙岩街	仙岩街道
城东街道	城东街
八里庄街	八里庄街道
咸丰路街道	咸丰路街
南彭街道	南彭街
梅林街道	梅林街
文龙街	文龙街道
古楼街道	古楼街
新市街	新市街道
江南街	江南街道
东街	东街街道
墩子塘街	墩子塘街道
城南街	城南街道
洛阳路街	洛阳路街道
峻德路街	峻德路街道
西城街道	西城街
锦程街道	锦程街
新城街道	新城街
河套街道	河套街
渭滨街道	渭滨街
中华路街	中华路街道
金桥街道	金桥街
徽州街道	徽州街
光明街	光明街道
城东街道	城东街
楼山街	楼山街道
彭浦新村街道	彭浦新村街
新淮街道	新淮街
高桥营街道	高桥营街
扎细街	扎细街道
慈音街道	慈音街
寸金街道	寸金街
侨英街道	侨英街
化龙桥街	化龙桥街道
迎新街	迎新街道
钟埭街道	钟埭街
大兴街道	大兴街
山腰街道	山腰街
大庆街道	大庆街
沙朗街	沙朗街道
花园街	花园街街道
南村街	南村街道
城区街道	城区街
四青街道	四青街
童游街道	童游街
东兴街道	东兴街
下湄桥街道	下湄桥街
湖塘街	湖塘街道
米市巷街道	米市巷街
苔青街道	苔青街
阜康街道	阜康街
凌南街道	凌南街
兴龙街	兴龙街道
城中街道	城中街
八一路街	八一路街道
琶洲街道	琶洲街
沙溪街道	沙溪街
和平街道	和平街
河洲街道	河洲街
龙津街道	龙津街
嘉陵街道	嘉陵街
旺泉街道	旺泉街
兰江街道	兰江街
东关街道	东关街
温陈街道	温陈街
伊合昂街道	伊合昂街
五里店街道	五里店街
金牛山街	金牛山街道
东山街	东山街道
城东街道	城东街
新庄街	新庄街道
新港街道	新港街
高花街道	高花街
天津路街	天津路街道
福新街	福新街道
对湖街	对湖街道
张衡街道	张衡街
天津铁厂街	天津铁厂街道
汉沽街道	汉沽街
河西街道	河西街
长寿街	长寿街道
古南街道	古南街
朝阳街	朝阳街道
来龙门街道	来龙门街
乔司街	乔司街道
向阳街道	向阳街
华塘街	华塘街道
西关大街街道	西关大街
汉江路街	汉江路街道
鲁山街	鲁山道街道
北门街	北门街道
艾维尔沟街道	艾维尔沟街
双江街道	双江街
朝阳街	朝阳街道
荣华街道	荣华街
太乙路街道	太乙路街
老虎台街道	老虎台街
二仙桥街道	二仙桥街
韩家墩街道	韩家墩街
欢喜街	欢喜街道
曲江街道	曲江街
泉山街	泉山街道
大山洞街道	大山洞街
路北街	路北街道
广顺街道	广顺街
瞿阳街道	瞿阳街
迎风街	迎风街道
洛王街	洛王街道
新立街道	新立街
三棵树大街	三棵树大街街道
中城街道	中城街
河南街道	河南街
铁山街	铁山街道
东南街道	东南街
桃园街	桃园街道
盐井街	盐井街道
马街	马街街道
珠江路街道	珠江路街
先锋路街道	先锋路街
新华街道	新华街
敬亭山街道	敬亭山街
水南街道	水南街
大湖街道	大湖街
新城街道	新城街
新闸街道	新闸街
双盛街道	双盛街
均禾街道	均禾街
江埔街道	江埔街
天福路街	天福路街道
石马河街	石马河街道
嘉峪关路街道	嘉峪关路街
新阳路街道	新阳路街
贵驷街道	贵驷街
中华路街	中华路街道
北地街	北地街道
天平路街道	天平路街
中华北路街	中华北路街道
灵昆街道	灵昆街
枣子坪街	枣子坪街道
城区街道	城区街
谷亭街道	谷亭街
兴隆街	兴隆街道
大研街道	大研街
文新街	文新街道
颍西街道	颍西街
甘蔗街道	甘蔗街
北干道街道	北干街
遮浪街道	遮浪街
中梁山街	中梁山街道
柴桥街道	柴桥街
菱湖街	菱湖街道
城西街	城西街道
雄石街道	雄石街
团结街	团结街道
椿树街	椿树街道
三官庙街	三官庙街道
展茅街	展茅街道
黄巷街道	黄巷街
葛城街道	葛城街
新城街道	新城街
莞城街	莞城街道
胡家园街道	胡家园街
龙山街	龙山街道
转塘街	转塘街道
霞林街	霞林街道
吴航街道	吴航街
观前街道	观前街
驿马街道	驿马街
八里庄街	八里庄街道
良田街	良田街道
太平新城街	太平新城街道
泗河街道	泗河街
西高皇街道	西高皇街
城西街	城西街道
通伸街道	通伸街
七里街	七里街道
双阳街道	双阳街
新城街道	新城街
石路街道	石路街
新成街道	新成街
观音桥街道	观音桥街
城东街道	城东街
华大街	华大街道
湍河街	湍河街道
南航街道	南航街
苏坡街	苏坡街道
东城街	东城街道
建国街道	建国街
中华南路街	中华南路街道
红桥街道	红桥街
凌凤街道	凌凤街
长乐西路街道	长乐西路街
凤凰街	凤凰街街道
岭西街道	岭西街
和平街道	和平街
保定街	保定街道
洺南街道	洺南街
八廓街	八廓街道
玉皇街	玉皇街道
古城台街道	古城台街
二十里堡街道	二十里堡街
河西街道	河西街
新兴街	新兴街道
渡舟街	渡舟街道
辛安渡街	辛安渡街道街道
富强街道	富强街
郭巷街道	郭巷街
黛溪街道	黛溪街
新兴街	新兴街道
航宇路街	航宇路街道
东城街	东城街道
布吉街道	布吉街
四季青街	四季青街道
东城街	东城街道
白龙街道	白龙街
望海街道	望海街
跳伞塔街	跳伞塔街道
石湾街道	石湾街
平安街道	平安街
沙冲路街	沙冲路街道
洮昌街道	洮昌街
光明路街道	光明路街
小龙坎街道	小龙坎街
泉河街道	泉河街
道德街	道德街街道
窑街	窑街街道
鼓楼西街街道	鼓楼西街
汉中街道	汉中街
望城坡街	望城坡街道
晋源街道	晋源街
团结路街道	团结路街
任丘路街	任丘路街道
郑山街	郑山街道
东城街	东城街道
李集街	李集街道
东明路街	东明路街道
九龙街道	九龙街
莘亭街	莘亭街道
河滨街道	河滨街
智远街	智远街道
北郊街道	北郊街
沙面街道	沙面街
洞山街道	洞山街
东山街	东山街道
工业区街	工业区街道
东城街	东城街道
登州街道	登州街
冠山街道	冠山街
韭菜园街	韭菜园街道
东风街	东风街道
胜利路街道	胜利路街
大西街	大西街道
新明街道	新明街
祥平街	祥平街道
矿里街道	矿里街
三江街	三江街道
西安街	西安街道
西乡街	西乡街道
龙门街道	龙门街
中山街道	中山街
栗乡街	栗乡街道
东市街道	东市街
城南街	城南街道
新平旺街	新平旺街道
森工街道	森工街
调兵山街	调兵山街道
新港街道	新港街
古吕街道	古吕街
玉海街	玉海街道
象鼻街道	象鼻街
永昌街	永昌街道
迪荡街道	迪荡街
长淮街道	长淮街
东城街	东城街道
红海街道	红海街
永昌街	永昌街道
圣灯街道	圣灯街
朐阳街道	朐阳街
新市区街	新市区街道
铁塔街道	铁塔街
东林街道	东林街
朝晖街道	朝晖街
伍家岗街	伍家岗街道
前进街	前进街道
林山寨街	林山寨街道
北镇街	北镇街道
东孝街道	东孝街
九台街道	九台街
五里墩街	五里墩街街道
南坊街道	南坊街
爱建街道	爱建街
金碧街	金碧街道
西苑街	西苑街道
下朱庄街	下朱庄街道
兰陵街	兰陵街道
田东街	田东街道
油槐街道	油槐街
一品街道	一品街
江北街	江北街道
大学东路街道	大学东路街
石埠街道	石埠街
黄河路街道	黄河路街
黎明街	黎明街道
中兴街道	中兴街
江南街	江南街道
深井子街道	深井子街
新街街道	新街
北寿街	北寿街道
翟庄街道	翟庄街
日照街道	日照街
奎山街道	奎山街
角嘴街	角嘴街道
解放西街街道	解放西街
天河街道	天河街
长北街	长北街道
望岳路街	望岳路街道
连山街道	连山街
辽海街道	辽海街
大桥街道	大桥街
明东街道	明东街
永清街	永清街道
浮山街道	浮山街
向阳街道	向阳街
泺口街	泺口街道
铁南街	铁南街道
合江街道	合江街
老鸦陈街道	老鸦陈街
裕强街	裕强街道
得胜街道	得胜街
羊坊店街	羊坊店街道
永定街	永定街道
江北街	江北街道
猎德街	猎德街道
六石街	六石街道
威清路街	威清路街道
西环中街街道	西环中街
北城街道	北城街
江浦路街道	江浦路街
搬口街道	搬口街
新村街道	新村街
永叔街	永叔街道
南湖南路街道	南湖南路街
周矶街道	周矶街
焦家湾街道	焦家湾街
长安路街	长安路街道
城西街	城西街道
千渭街	千渭街道
朝阳街	朝阳街道
滨湖街道	滨湖街
海龙街	海龙街道
东湖街	东湖街道
几江街道	几江街
太平大街	太平大街街道
崮云湖街道	崮云湖街
新嘉街道	新嘉街
沌口街	沌口街街道
北旺庄街	北旺庄街道
包公街道	包公街
中原路街道	中原路街
抚琴街	抚琴街道
将军堡街道	将军堡街
桥南街道	桥南街
仙女山街	仙女山街道
吕仙亭街道	吕仙亭街
酂阳街	酂阳街道
广安门外街	广安门外街道
雕庄街道	雕庄街
将军路街	将军路街道
南塔街道	南塔街
河浦街道	河浦街
大公桥街道	大公桥街
兴顺街道	兴顺街
南宁街	南宁街道
浑河湾街道	浑河湾街
乌鲁木齐西路街道	乌鲁木齐西路街
菱北街	菱北街道
新华街道	新华街
西坝街道	西坝街
丰满街道	丰满街
竹岛街道	竹岛街
鱼邱湖街	鱼邱湖街道
兆麟街	兆麟街道
崇文街	崇文街道
稽山街道	稽山街
北城街道	北城街
南营门社区街道	南营门社区街
义蓬街道	义蓬街
孙武街	孙武街道
兴泰街	兴泰街道
向阳街道	向阳街
南城街道	南城街
卧龙岗街	卧龙岗街道
桃西街道	桃西街
燕山大街街道	燕山大街
大郭庄街	大郭庄街道
东兴寺街道	东兴寺街
任圩街道	任圩街
林东西城街	林东西城街道
留园街道	留园街
江苏路街	江苏路街道
蜀山街道	蜀山街
陵西街道	陵西街
黔灵东路街	黔灵东路街道
晓云街道	晓云街
慈湖街道	慈湖街
李棋街道	李棋街
人和街	人和街道
系马桩街道	系马桩街
松花江街道	松花江街
庆阳街道	庆阳街
天生港镇街	天生港镇街道
建国路街道	建国路街
奴尔巴格街道	奴尔巴格街
石碶街道	石碶街
文东街道	文东街
草滩街	草滩街道
沪东新村街	沪东新村街道
三店街	三店街道
王村街道	王村街
新华街	新华街街道
北城街道	北城街
哈达街道	哈达街
龙洲湾街	龙洲湾街道
东明街	东明街道
塔湾街	塔湾街道
谷阳街道	谷阳街
诃额伦街道	诃额伦街
坪东街	坪东街道
凤山街	凤山街道
新明街道	新明街
钢都街道	钢都街
民治街道	民治街
通阳街	通阳道街道
建安街道	建安街
吉林街	吉林街道
龙眠街道	龙眠街
沙头街道	沙头街
南城街道	南城街
双屿街道	双屿街
玉屏街	玉屏街道
龙子湖街道	龙子湖街
东亭街道	东亭街
桂园街道	桂园街
甘庄街	甘庄街道
屏山街	屏山街道
百泉街道	百泉街
杏树街	杏树街道
路桥街道	路桥街
西津街道	西津街
航海东路街	航海东路街道
火炬街	火炬街道
古美街	古美街道
张其寨街道	张其寨街
兴业街道	兴业街
东风街	东风街道
官坊街	官坊街道
西铭街道	西铭街
沙井街道	沙井街
香店街	香店街道
西洲街道	西洲街
济河街道	济河街
东荆街	东荆街道
峡山街	峡山街道
鄢城街道	鄢城街
虎石台街	虎石台街道
新村街道	新村街
东街	东街街道
蚺城街道	蚺城街
兴建街道	兴建街
向阳街道	向阳街
新利街道	新利街
鸣鹿街道	鸣鹿街
七百间街	七百间街道
丁堰街道	丁堰街
岳塘街道	岳塘街
玉带路街	玉带路街道
新湖街道	新湖街
金泉街	金泉街道
辛安街道	辛安街
拱辰街道	拱辰街
义洲街道	义洲街
新城街道	新城街
花湖街	花湖街道
柳行街	柳行街道
深北街	深北街道
泰山街道	泰山街
长东街道	长东街
高德街道	高德街
黄桷坪街	黄桷坪街道
八大湖街	八大湖街道
柳园街	柳园街道
丰荣街道	丰荣街
水磨沟街	水磨沟街道
新兴街	新兴街道
九峰街道	九峰街
鼓楼街	鼓楼街道
北新泾街	北新泾街道
南峰街	南峰街道
同安路街道	同安路街
大孤山街道	大孤山街
新华街	新华街街道
城东街道	城东街
坑梓街道	坑梓街
翠屏街道	翠屏街
衡阳街道	衡阳街
裕东街道	裕东街
柳南街道	柳南街
詹家溪街	詹家溪街道
东兴街道	东兴街
东坡街	东坡街道
南京西路街	南京西路街道
荆公路街	荆公路街道
中河街	中河街道
鹏泉街	鹏泉街道
永安坝街道	永安坝街
大凌河街	大凌河街道
飞彩街道	飞彩街
龙洞街	龙洞街道
姚孟街道	姚孟街
和平路街道	和平路街
清真街道	清真街
东湖街	东湖街道
东山街	东山街道
南洲街道	南洲街
龙桥街道	龙桥街
常泰街道	常泰街
长征街	长征街街道
北桥街道	北桥街
白银路街	白银路街道
河东街	河东街道
奎聚街道	奎聚街
城北街	城北街道
大磁街	大磁街道
新一街道	新一街
圣城街道	圣城街
杜曲街道	杜曲街
冯封街	冯封街道
峰江街道	峰江街
新安街道	新安街
兴工街道	兴工街
燕山路街	燕山路街道
新华街	新华街街道
花地街道	花地街
袁河街道	袁河街
花园街道	花园街
天安街	天安街道
洛浦街道	洛浦街
纸坊街	纸坊街道
北京路街	北京路街道
北山街	北山街道
三垟街	三垟街道
滨兴街	滨兴街道
七一街道	七一街
小东门街	小东门街道
仰义街道	仰义街
北峰街	北峰街道
金鸡坡街道	金鸡坡街
南城街道	南城街
东风街	东风街道
杜岭街	杜岭街街道
坞城街	坞城街道
泉庄街道	泉庄街
祁州药市街	祁州药市街道
田集街道	田集街
马场坪街道	马场坪街
埇桥街道	埇桥街
城郊街道	城郊街
墩上街道	墩上街
延江街	延江街道
大观街道	大观街
街口街道	街口街
沿丰街	沿丰街道
响堂街	响堂街道
南站街	南站街道
三里街	三里街街道
胜园街道	胜园街
归州街道	归州街
站北街	站北街道
天塔街道	天塔街
吴门桥街	吴门桥街道
太乙宫街道	太乙宫街
汶上街道	汶上街
西城区街	西城区街道
锦绣街道	锦绣街
花果街道	花果街
峰高街道	峰高街
谭家街道	谭家街
蒋王街	蒋王街道
贺兰山西路街道	贺兰山西路街
官扎营街道	官扎营街
石岩街道	石岩街
江源街	江源街道
贞山街道	贞山街
东湖街	东湖街道
酒仙桥街道	酒仙桥街
枚乘路街	枚乘路街道
缸窑沟街	缸窑沟街道
竹行街道	竹行街
民生路街	民生路街道
健康路街道	健康路街
青山路街道	青山路街
江北街	江北街道
和瑞街	和瑞街道
凤凰山街	凤凰山街道
南关街道	南关街
城区街道	城区街
草市街	草市街街道
螺洋街	螺洋街道
军粮城街	军粮城街道
幸福路街道	幸福路街
将军路街	将军路街道
路东街道	路东街
火车西站街道	火车西站街
万兴街道	万兴街
城陵矶街	城陵矶街道
古城街	古城街道
准东街道	准东街
广润门街	广润门街道
张掖路街	张掖路街道
中同街街道	中同街
北蒙街	北蒙街道
鲁阳街道	鲁阳街
河西街道	河西街
北海街	北海街道
燕子山街	燕子山街道
津城街道	津城街
曹娥街道	曹娥街
太安街道	太安街
禄脿街道	禄脿街
唐家房街	唐家房街道
八八街	八八街道
宁城街	宁城街道
云红街道	云红街
益民街道	益民街
驾鹤街道	驾鹤街
曙光街	曙光街道
上地街道	上地街
元通街道	元通街
南京东路街	南京东路街道
春晓街	春晓街道
北环路街	北环路街道
天问街	天问街道
桃花仑街	桃花仑街道
大丰街	大丰街道
蒋村街道	蒋村街
姚家街道	姚家街
安民街	安民街道
午朝门街道	午朝门街
长春路街道	长春路街
六甲街	六甲街道
南山街	南山街道
中山路街	中山路街道
永定路街	永定路街道
沙东街道	沙东街
双月湖街道	双月湖街
七路街道	七路街
平安街道	平安街
潘家沟街	潘家沟街道
七马路街道	七马路街
兴南街道	兴南街
望海寺街	望海寺街道
建设街道	建设街
永祥街	永祥街道
南湾街道	南湾街
武定府街	武定府街道
文化路街道	文化路街
王陵街	王陵街道
美里湖街	美里湖街道
东关街道	东关街
黄河道街道	黄河街
春江街道	春江街
东高地街	东高地街道
大兴街道	大兴街
长田街	长田街道
任港街道	任港街
北道门街道	北道门街
东宁街	东宁街道
安邑街	安邑街道
盐市口街	盐市口街道
待王街	待王街道
沂城街道	沂城街
瀍西街道	瀍西街
文汇街	文汇街道
滨海路街道	滨海路街
友新街道	友新街
七贤街	七贤街道
黄河西路街道	黄河西路街
共和新路街道	共和新路街
向阳楼街	向阳楼街道
云溪街道	云溪街
北门街	北门街道
城子河街	城子河街道
保健路街	保健路街道
云东海街道	云东海街
前进街	前进街道
银滩路街道	银滩路街
八卦城街	八卦城街道
南门街	南门街道
凯旋街道	凯旋街
田和街	田和街道
金湖街	金湖街道
鼓东街	鼓东街道
湛郎街道	湛郎街
小井峪街道	小井峪街
满江街	满江街道
东阳街道	东阳街
城南街	城南街道
蜜蜂张街道	蜜蜂张街
项里街道	项里街
都正街	都正街街道
草街	草街街道
河东街	河东街道
铁人街道	铁人街
创新街道	创新街
文化路街道	文化路街
安庆路街道	安庆路街
拾屯街	拾屯街道
吉和街道	吉和街
净月街道	净月街
冼村街	冼村街道
腰卜街	腰卜街道
青山街道	青山街
新虹街道	新虹街
白鹤洞街道	白鹤洞街
河北街道	河北街
安阳街道	安阳街
阜安街	阜安街道
西流湖街道	西流湖街
十里铺街道	十里铺街
府城街	府城街道
南头街道	南头街
大庆路街道	大庆路街
龙洲街道	龙洲街
英雄南路街道	英雄南路街
柳林街道	柳林街
院格庄街道	院格庄街
崇安寺街道	崇安寺街
江北街	江北街道
三家子街道	三家子街
北站街	北站街道
重阳街	重阳街道
安定门街	安定门街道
友好街	友好街道
后湖街	后湖街街道
建宁街道	建宁街
建设街道	建设街
前进街	前进街道
珠吉街道	珠吉街
东关街道	东关街
济阳街道	济阳街
汉城街	汉城街道
河西街道	河西街
巴彦浩特王府街	巴彦浩特王府街道
海星街	海星街道
八大关街	八大关街道
东街道	东街
拱宸桥街	拱宸桥街道
梅湾街道	梅湾街
大石坝街道	大石坝街
龙兴街道	龙兴街
金乡街	金乡街道
提篮桥街道	提篮桥街
东关街道	东关街
白沙洲街道	白沙洲街
丽君街	丽君街道
桃源街道	桃源街
峡山口街	峡山口街道
七星岗街	七星岗街道
湾仔街道	湾仔街
北关街道	北关街
柏杨街	柏杨街道
亳州路街道	亳州路街
水口街道	水口街
海青岛街道	海青岛街
新堤街	新堤街道
光华街	光华街道
胜利街	胜利街街道
明西街	明西街道
时庄街道	时庄街
舟白街道	舟白街
三条石街	三条石街道
南营坊街道	南营坊街
曙光街街道	曙光街
文山街	文山街道
东关南街街道	东关南街
大发街	大发街道
开元街道	开元街
大秦家街道	大秦家街
荷花池街	荷花池街道
晋阳街	晋阳街道
浦阳街道	浦阳街
岭南街道	岭南街
奓山街道	奓山街
寻山街道	寻山街
矿市街	矿市街街道
海滨街	海滨街道
延安路街道	延安路街
济川街道	济川街
九里亭街	九里亭街道
孔浦街	孔浦街道
光明街	光明街道
白沙澫街	白沙澫街道
珞南街	珞南街道
龙渊街道	龙渊街
大同街道	大同街
三山街	三山街道
辽河街	辽河街道
荆各庄街道	荆各庄街
白莲街	白莲街道
广水街道	广水街
新河路街道	新河路街
下浦街道	下浦街
常青街	常青街道
盐仓街道	盐仓街
永清街	永清街街道
平东街	平东街道
万里路街	万里路街道
明南街	明南街道
建设街道	建设街
南街	南街街道
宝塔河街道	宝塔河街
麦子店街	麦子店街道
九莲街	九莲街道
天门山街道	天门山街
泉峰街道	泉峰街
毓龙街道	毓龙街
北山街	北山街道
山洞街	山洞街道
宝塔街道	宝塔街
大明宫街道	大明宫街
唐洞街道	唐洞街
厂口街	厂口街道
卫都街	卫都街道
左家塘街	左家塘街道
相南街道	相南街
近海街	近海街道
西固城街	西固城街道
孙家湾街	孙家湾街道
向阳街道	向阳街
振兴街道	振兴街
白洞街道	白洞街
沿江街	沿江街道
陆家嘴街道	陆家嘴街
南市街道	南市街
火花街道	火花街
山城街	山城街道
韩村北路街道	韩村北路街
公园路街	公园路街道
崖底街道	崖底街
武当路街	武当路街道
西新街	西新街道
皇冠街	皇冠街道
慧阳街道	慧阳街
平山街道	平山街
永昌街	永昌街道
雨花亭街道	雨花亭街
华兴街道	华兴街
北城街道	北城街
北城街道	北城街
五里牌街	五里牌街道
成家川街道	成家川街
焦东街道	焦东街
佃户屯街	佃户屯街道
裕华街道	裕华街
张家湾街	张家湾街道
南城街道	南城街
海头街道	海头街
西永街	西永街道
大港街	大港街道
白云街道	白云街
三八街道	三八街
江南街	江南街道
四微街道	四微街
南街	南街街道
建南街道	建南街
金银川路街道	金银川路街
金雀山街道	金雀山街
越秀路街	越秀路街道
宝山路街	宝山路街道
郓州街道	郓州街
利民路街	利民路街道
十里街道	十里街
马冲口街	马冲口街道
凤山街	凤山街道
河南岸街道	河南岸街
贵筑街道	贵筑街
贡井街道	贡井街
大陆街道	大陆街
汀田街道	汀田街
金霞街	金霞街道
天宝路街	天宝路街道
郑州路街道	郑州路街
玉泉街	玉泉街道
道义街道	道义街
北兴街道	北兴街
莱山街	莱山街道
燕北街道	燕北街
义井街道	义井街
官塘桥街	官塘桥街道
王连街道	王连街
河北街道	河北街
金仓街道	金仓街
太平街	太平街道
四牌楼街	四牌楼街道
银山街道	银山街
新华街	新华街街道
南门街	南门街道
东华街	东华街道
良乡地区
文官街	文官街道
渤海街道	渤海街
永明路街	永明路街道
申港街道	申港街
曙光街	曙光街道
湓城街道	湓城街
明阳街道	明阳街
狮山街道	狮山街
翟家街道	翟家街
茶山街道	茶山街
金宇街	金宇街道
开元街道	开元街
城南街	城南街道
南城区街	南城区街道
南湖街道	南湖街
王府街	王府街道
东海街道	东海街
得胜街道	得胜街
荣校路街道	荣校路街
广中路街道	广中路街
拱辰街道	拱辰街
陵城街道	陵城街
创业园街	创业园街道
都亭街	都亭街道
龙凤街道	龙凤街
通城街道	通城街
南区街道	南区街
长轩岭街	长轩岭街道
新城街道	新城街
红卫街	红卫街道
八马路街道	八马路街
谢三村街	谢三村街道
瑞光街道	瑞光街
金峰路街道	金峰路街
建设路街道	建设路街
南关街道	南关街
朝阳街	朝阳街道
华阳镇街	华阳镇街道
罗峰街	罗峰街道
昱东街道	昱东街
十里店街道	十里店街
北关街道	北关街
车陂街道	车陂街
葛塘街道	葛塘街
解甲庄街	解甲庄街道
会龙山街	会龙山街道
灵隐街道	灵隐街
百春园街	百春园街道
运河西街道	运河西街
安塘街道	安塘街
狮子楼街道	狮子楼街
平庄西城街	平庄西城街道
安乐街道	安乐街
营前街	营前街道
光荣街道	光荣街
张家山街	张家山街道
四老沟街道	四老沟街
洪凝街道	洪凝街
古荡街	古荡街道
中山门街道	中山门街
布溪街道	布溪街
八一桥街道	八一桥街
和平街道	和平街
城关街道	城关街
沙河源街道	沙河源街
云集街	云集街道
上白作街	上白作街道
仁里街道	仁里街
逢源街道	逢源街
梅录街	梅录街道
南明街道	南明街
水月寺街道	水月寺街
八步街	八步街道
钰华街道	钰华街
西街	西街道
桃园街	桃园街道
七道湾街	七道湾街道
大麦屿街道	大麦屿街
市中街道	市中街
曙光街	曙光街道
浦楼街道	浦楼街
马栏街道	马栏街
镇江路街	镇江路街道
中山街道	中山街
青年公园街	青年公园街道
八坊街道	八坊街
江安街	江安街道
徐家棚街街道	徐家棚街
迎丰街	迎丰街道
城东街道	城东街
九郊街	九郊街道
贺家土街道	贺家土街
西河区街道	西河区街
新兴街	新兴街道
凤城街	凤城街道
民安街	民安街道
南京路街	南京路街道
杭州道街道	杭州街
潘塘街道	潘塘街
东塔街道	东塔街
龙洞街	龙洞街道
东方红街	东方红街道
望城街道	望城街
乐坪街	乐坪街道
钟家庄街	钟家庄街道
尖草坪街	尖草坪街道
上马街	上马街道
环城西路街道	环城西路街
文峰街	文峰街道
天桥东街	天桥东街街道
东关街道	东关街
六合街道	六合街
和平里街	和平里街道
文汇路街	文汇路街道
珍珠街道	珍珠街
道东街	道东街道
祝家街道	祝家街
饮马街	饮马街街道
永丰街道	永丰街
富源街	富源街道
崔东街道	崔东街
榕华街道	榕华街
中山街	中山街街道
南岗街	南岗街道
南山街	南山街道
接庄街道	接庄街
营城子街	营城子街道
清波街	清波街道
雷城街道	雷城街
和平街道	和平街
高升街道	高升街
韩森寨街道	韩森寨街
剑光街	剑光街道
西华街道	西华街
黎托街	黎托街道
靖远路街	靖远路街道
四平路街	四平路街道
平桥街	平桥街道
中专路街	中专路街道
塔山街	塔山街道
中山街道	中山街
昭阳街	昭阳街道
会城街道	会城街
灵沼街道	灵沼街
广州路街道	广州路街
泰前街	泰前街道
文兰街	文兰街道
夏桥街道	夏桥街
通胜街	通胜街道
贵乌路街道	贵乌路街
凤垭街道	凤垭街
古城街	古城街道
乌东路街道	乌东路街
大沽街道	大沽街
中心街	中心街道
张槎街道	张槎街
仲景街道	仲景街
稠城街道	稠城街
金海路街	金海路街道
七星街道	七星街
黑石礁街	黑石礁街道
滨海街道	滨海街
岳阳楼街道	岳阳楼街
东工人镇街道	东工人镇街
嘉祥镇街	嘉祥镇街道
昆山街道	昆山街
辽滨街道	辽滨街
韦曲街道	韦曲街
杭州路街	杭州路街道
平湖街道	平湖街
沙井街道	沙井街
浭阳街	浭阳街道
北局宅街道	北局宅街
雪松街道	雪松街
文昌街道	文昌街
武林街	武林街道
城南街	城南街道
东海街道	东海街
长春街道	长春街
新华街道	新华街
龙门街道	龙门街
矣六街	矣六街道
江南街	江南街道
兴隆街	兴隆街道
二里岗街道	二里岗街
芦林街	芦林街道
朝阳门街	朝阳门街道
大北街	大北街道
白河街	白河街道
新河街道	新河街
天通苑北街道	天通苑北街
龙洞街	龙洞街道
镇湖街道	镇湖街
苍霞街道	苍霞街
容桂街道	容桂街
古楼街道	古楼街
建设路街道	建设路街
大通路街道	大通路街
双岛湾街	双岛湾街道
沙塘路街道	沙塘路街
汉兴街	汉兴街街道
人民路街道	人民路街
北京路街	北京路街道
重庆路街	重庆路街道
崇文路街	崇文路街道
荣巷街道	荣巷街
大南街街道	大南街
永安路街	永安路街道
半截河街道	半截河街
东花市街	东花市街道
锦北街	锦北街道
鼓楼街	鼓楼街道
康桥街道	康桥街
西环路街	西环路街道
小关街道	小关街
二七街	二七街街道
坨院街	坨院街道
张集街道	张集街
泡子沿街道	泡子沿街
徐家湾街	徐家湾街道
遵义街道	遵义街
渭阳街	渭阳街道
舜玉路街道	舜玉路街
中华路街	中华路街道
靠山街道	靠山街
下摄司街道	下摄司街
德山街	德山街道
红星街道	红星街
石佛寺街	石佛寺街道
府前街道	府前街
谢桥街道	谢桥街
站南街	站南街道
新华路街	新华路街道
勒流街道	勒流街
江东街道	江东街
永安街道	永安街
临城街	临城街道
兴达街	兴达街道
湖里街道	湖里街
灵珠山街	灵珠山街道
泉山街	泉山街道
东大街道	东大街
中城街道	中城街
陆水湖街	陆水湖街道
工业园街道	工业园街
新城街道	新城街
坚木克尔街道	坚木克尔街
雀儿山街	雀儿山街道
新都街	新都街道
八一街道	八一街
郢中街道	郢中街
路西街	路西街道
小江湖街道	小江湖街
苇子沟街	苇子沟街道
高峪街	高峪街道
金水街道	金水街
杨圪楞街道	杨圪楞街
长丰街	长丰街道
龙江街	龙江街道
河东街	河东街道
文冲街道	文冲街
澄月街	澄月街道
张宽街	张宽街道
颍南街道	颍南街
中岳街	中岳街道
姜格庄街	姜格庄街道
城北街	城北街道
东城街	东城街道
星沙街	星沙街道
后宰门街道	后宰门街
书院街道	书院街
新北街道	新北街
沙坪街道	沙坪街
浮山路街道	浮山路街
新华街道	新华街
新安街道	新安街
奎山街道	奎山街
金匮街	金匮街道
民主街道	民主街
开州街道	开州街
周路口街道	周路口街
江堤街	江堤街街道
新区街	新区街道
八一街道	八一街
黄庄街道	黄庄街
邵家渡街道	邵家渡街
天平街道	天平街
蔡榨街道	蔡榨街
东河街道	东河街
蒲圻街	蒲圻街道
宁夏路街	宁夏路街道
沙河街道	沙河街
蔡家岗街	蔡家岗街道
西里街道	西里街
匡山街	匡山街道
青龙街道	青龙街
南马街道	南马街
黄忠街	黄忠街道
凤凰路街	凤凰路街道
沈水湾街道	沈水湾街
乌牛街道	乌牛街
煤峪口街	煤峪口街道
江口街道	江口街
田林街道	田林街
北街	北街街道
西上庄街	西上庄街道
东苑街	东苑街道
棉北街	棉北街道
遵义路街	遵义路街道
高埔岗街	高埔岗街道
陈坪街	陈坪街道
虹梅路街	虹梅路街道
卫星湖街	卫星湖街道
渤海石油街道	渤海石油街
初家街道	初家街
人民路街道	人民路街
心圩街道	心圩街
云山街	云山街道
珠海街道	珠海街
钻石路街	钻石路街道
辽南街道	辽南街
和平街	和平街街道
菁城街	菁城街道
燕儿窝街	燕儿窝街道
墟沟街	墟沟街道
航城街道	航城街
卢沟桥街道	卢沟桥街
龙井街道	龙井街
坝陵街	坝陵街道
大亚湾霞涌街道	大亚湾霞涌街
新河街道	新河街
欧阳路街	欧阳路街道
中华路街	中华路街道
桥北街道	桥北街
白马街道	白马街
三井街道	三井街
北苑街	北苑街道
东关街道	东关街
建设路街道	建设路街
奎阁街道	奎阁街
灵源街道	灵源街
南湖北路街道	南湖北路街
龙翔街道	龙翔街
阿尔丁大街	阿尔丁大街街道
两路街道	两路街
永华道街道	永华街
大潘街	大潘街道
青白石街道	青白石街
叠彩街道	叠彩街
泉秀街道	泉秀街
人民北路街道	人民北路街
东岳路街道	东岳路街
长兴街道	长兴街
蕉北街	蕉北街道
石岗大街街道	石岗大街
福利路街	福利路街道
茨坝街	茨坝街道
西兴街道	西兴街
海棠溪街	海棠溪街道
重庆街道	重庆街
新建街	新建街道
水东街道	水东街
黄河街道	黄河街
茶亭街道	茶亭街
国庆街道	国庆街
东环路街道	东环路街
凤凰北街街道	凤凰北街
五七路街道	五七路街
黎明街	黎明街道
汪家桥街	汪家桥街道
山前街道	山前街
曲线街道	曲线街
高坎街道	高坎街
南津街街道	南津街
西溪街道	西溪街
海丰街	海丰街道
中心路街	中心路街道
高台子镇街道	高台子镇街
中庙街道	中庙街
望江街道	望江街
海北街	海北街道
古湖街	古湖街道
高笋塘街	高笋塘街道
税务庄街	税务庄街道
金沙街	金沙街道
周家坝街道	周家坝街
同家梁街道	同家梁街
中兴路街道	中兴路街
金阳街道	金阳街
紫荆山街	紫荆山街道
青屏街	青屏街街道
新辉路街	新辉路街道
天桥街	天桥街街道
金辰街道	金辰街
白杨街道	白杨街
东坝街道	东坝街
新华路街	新华路街道
镇东街道	镇东街
均州路街道	均州路街
钢花村街	钢花村街道
南康街	南康街道
狮子山街道	狮子山街
龙池街道	龙池街
黄村街	黄村街道
陈家桥街道	陈家桥街
新区街	新区街道
赣江街道	赣江街
珠泉街道	珠泉街
富兴堡街	富兴堡街道
二号桥街	二号桥街道
灵台县街道	灵台县街
海拉尔东路街	海拉尔东路街道
贵石沟街	贵石沟街道
廿里铺街	廿里铺街道
蒋乔街	蒋乔街道
建宁路街道	建宁路街
临湖街	临湖街道
平江街道	平江街
奋斗街道	奋斗街
花楼街	花楼街街道
矿建街道	矿建街
城关街道	城关街
新桥街	新桥街道
广厦街道	广厦街
安宁街	安宁街道
走马岭街	走马岭街道
璧泉街	璧泉街道
海昌街道	海昌街
集美街	集美街道
钟公庙街道	钟公庙街
二马路街道	二马路街
高庄街	高庄街道
纬北路街道	纬北路街
胡家街	胡家街道
华山街道	华山街
天桥街道	天桥街
洞井街道	洞井街
红旗路街	红旗路街道
紫金街街道	紫金街
伦教街道	伦教街
龙潭街道	龙潭街
东方街	东方街道
中山西路街道	中山西路街
复兴街道	复兴街
城西街	城西街道
东莱街	东莱街道
东门街	东门街道
西丁街	西丁街道
工人村街道	工人村街
王城路街道	王城路街
滨江街道	滨江街
新丰街道	新丰街
风穴路街	风穴路街道
电力街	电力街道
河雍街	河雍街道
先锋路街道	先锋路街
惜福镇街道	惜福镇街
新疆街道	新疆街
温泉街	温泉街道
黄土坡街道	黄土坡街
城区街道	城区街
板桥街道	板桥街
绳金塔街	绳金塔街道
莲前街道	莲前街
里村街	里村街道
湘潭街	湘潭街道
萧王庙街	萧王庙街道
上华街道	上华街
公园街道	公园街
黄楼街道	黄楼街
长通街道	长通街
骅中街	骅中街道
友谊路街道	友谊路街
虎溪街道	虎溪街
城北街	城北街道
麒麟街道	麒麟街
武夷街	武夷街道
江南街	江南街道
沿江街	沿江街道
梅花山街	梅花山街道
辛家庙街	辛家庙街道
卧龙寺街道	卧龙寺街
红村街道	红村街
挹江门街	挹江门街道
水渡口街	水渡口街道
滨河路街道	滨河路街
会战街道	会战街
曙光街	曙光街道
新城街道	新城街
青龙街道	青龙街
彭后街道	彭后街
公园街道	公园街
徐家井街道	徐家井街
歪头山街道	歪头山街
伯都讷街道	伯都讷街
黄思湾街	黄思湾街道
彭驿站街	彭驿站街道
东兴街道	东兴街
北村街	北村街道
济阳街道	济阳街
贵和街道	贵和街
林家崖街道	林家崖街
富山街	富山街道
新南街道	新南街
宋家桥街道	宋家桥街
高岳街道	高岳街
合江亭街道	合江亭街
大营街街道	大营街
太平路街	太平路街道
开平街道	开平街
城南街	城南街道
沙井驿街	沙井驿街道
邱皮沟街	邱皮沟街道
永乐街道	永乐街
东里街道	东里街
安泰街道	安泰街
大里街道	大里街
西郊街道	西郊街
城东街道	城东街
七一路街	七一路街道
东风街	东风街道
东城街	东城街道
市府路街	市府路街道
七里墩街道	七里墩街
仓门街	仓门街街道
演马街道	演马街
青江街道	青江街
龙城街	龙城街道
两路口街道	两路口街
城西街	城西街道
北大街街道	北大街
团结街	团结街道
小凌河街道	小凌河街
首南街	首南街道
滏东街道	滏东街
新庙街道	新庙街
兴园街道	兴园街
莲花街道	莲花街
文峰街	文峰街道
桂花街道	桂花街
桥头街道	桥头街
垦利街道	垦利街
流亭街道	流亭街
煤山街	煤山街道
五峰山街	五峰山街道
思山岭街道	思山岭街
沼潭街道	沼潭街
葭沚街	葭沚街道
劝业场街	劝业场街道
成吉思汗大街	成吉思汗大街街道
新华西街	新华西街道
巷口街道	巷口街
花戏楼街道	花戏楼街
新兴街	新兴街道
三洲驿街	三洲驿街道
城关街道	城关街
保康街道	保康街
段店北路街	段店北路街道
城西街	城西街道
汉屯路街	汉屯路街道
哈达湾街	哈达湾街道
东山街	东山街道
东环街道	东环街
南范各庄街	南范各庄街道
斯大林街	斯大林街道
金牛湖街道	金牛湖街
先锋街道	先锋街
豫让桥街	豫让桥街道
新市街	新市街道
燕南街道	燕南街
小营街道	小营街
泉园街道	泉园街
厦港街	厦港街道
穗东街道	穗东街
五一街	五一街道
富宁街街道	富宁街
太阳升街道	太阳升街
鮀江街道	鮀江街
桃园街	桃园街道
门楼街	门楼街道
杏花村街	杏花村街道
蒋官屯街	蒋官屯街道
建国街道	建国街
化机街道	化机街
民生街	民生街道
敦煌路街	敦煌路街道
云山街	云山街道
北关街道	北关街
白纸坊街道	白纸坊街
南蒲街道	南蒲街
府山街	府山街道
向阳街道	向阳街
西站街	西站街道
双河口街道	双河口街
文北街	文北街道
田墘街道	田墘街
周家泉街	周家泉街道
新华路街	新华路街道
江边街	江边街道
子午街道	子午街
丹水池街街道	丹水池街
杏儿沟街	杏儿沟街道
荣光街道	荣光街
友谊街道	友谊街
中山街道	中山街
萨依布依街道	萨依布依街
春熙路街	春熙路街道
化林路街	化林路街道
胥江街道	胥江街
沙河街道	沙河街
龙山街	龙山街道
乌兰察布路街道	乌兰察布路街
西市场街道	西市场街
石马坪街	石马坪街道
穆棱街道	穆棱街
祥符街道	祥符街
洲头街街道	洲头街
中华门街	中华门街道
白沙路街	白沙路街道
城南街	城南街道
鼓西街道	鼓西街
昆仑街道	昆仑街
乐华街道	乐华街
玉城街	玉城街道
建设街道	建设街
朝阳街	朝阳街道
民族街	民族街街道
南浦街道	南浦街
王因街道	王因街
老军营街	老军营街道
东兴街道	东兴街
新北站街	新北站街道
尹家街	尹家街道
伍佑街道	伍佑街
满城北街街道	满城北街
笃工街	笃工街道
同升街道	同升街
东瓯街道	东瓯街
高新区七里河街道	高新区七里河街
罗星街	罗星街道
龙泉街	龙泉街道
甲山街道	甲山街
丈八沟街道	丈八沟街
桥东街道	桥东街
天河街道	天河街
重工街	重工街道
辽西街道	辽西街
乐白街	乐白道街道
长社路街道	长社路街
绿东村街道	绿东村街
北京路街	北京路街道
钟岭街道	钟岭街
蓝天街道	蓝天街
中南路街道	中南路街
财源街道	财源街
青磁窑街	青磁窑街道
鸿鹰街	鸿鹰街道
前进路街	前进路街道
牛街街道	牛街
弋江桥街道	弋江桥街
翠屏山街	翠屏山街道
平庄东城街道	平庄东城街
幸福路街道	幸福路街
梅墟街道	梅墟街
热斯坦街道	热斯坦街
六道湾街道	六道湾街
清香坪街道	清香坪街
唐闸镇街道	唐闸镇街
大禾塘街	大禾塘街道
广利街	广利街道
永丰街道	永丰街
南大街街道	南大街
海明街道	海明街
养马岛街	养马岛街道
长宁街	长宁街道
陈塬街	陈塬街道
五老村街道	五老村街
东江街道	东江街
衡州路街	衡州路街道
陈家坝街道	陈家坝街
新华街	新华街街道
回风街	回风街道
和兴路街道	和兴路街
工农街道	工农街
新兴街	新兴街道
新街街道	新街
沙河街道	沙河街
九宫庙街	九宫庙街道
小渡船街	小渡船街道
涡北街	涡北街道
济水街道	济水街
白藤街道	白藤街
凤川街道	凤川街
兴海街道	兴海街
少城街	少城街道
长兴岛街	长兴岛街道
靖江街	靖江街道
红旗楼街道	红旗楼街
海兰街	海兰街道
石竹街道	石竹街
工业街	工业街道
立新街道	立新街
泰山街道	泰山街
方亭街道	方亭街
龙桥街道	龙桥街
柏杨街	柏杨街道
抚东街	抚东街道
巴彦浩特南环路街	巴彦浩特南环路街道
城关街道	城关街
东马坊街道	东马坊街
永华街道	永华街
振华南街	振华南街街道
金谷园街	金谷园街道
曲阳路街道	曲阳路街
香洲街道	香洲街
十陵街道	十陵街
宁河街道	宁河街
前洲街	前洲街道
刘家堡街	刘家堡街道
黄金岭街道	黄金岭街
南环路街	南环路街道
纱厂路街	纱厂路街道
冶金街道	冶金街
安平街道	安平街
青杠街道	青杠街
嘎玛贡桑街道	嘎玛贡桑街
桂林街道	桂林街
弋矶山街	弋矶山街道
上园街道	上园街
曹山街	曹山街道
建设街道	建设街
盐田街道	盐田街
靳岗街道	靳岗街
胜利北路街道	胜利北路街
热河南路街	热河南路街道
鹿山街	鹿山街道
西吴街道	西吴街
石化街道	石化街
光荣街道	光荣街
金砂街道	金砂街
桥东街道	桥东街
车站街道	车站街
文华街道	文华街
富强街道	富强街
建设街道	建设街
调顺街道	调顺街
华明街	华明街道
朱刘街道	朱刘街
营市街街道	营市街
炳草岗街道	炳草岗街
昌岗街道	昌岗街
趵突泉街	趵突泉街道
城南街	城南街道
十里街道	十里街
车站街街道	车站街
荷叶地街	荷叶地街道
光明街	光明街道
南杜街道	南杜街
友谊街道	友谊街
官洲街	官洲街道
土湾街道	土湾街
双龙街	双龙街道
新华街道	新华街
石园街	石园街道
建丰街道	建丰街
城关街道	城关街
南湖街道	南湖街
高阳路街道	高阳路街
南山路街	南山路街道
朝外街道	朝外街
丰溪街	丰溪街道
彩虹街	彩虹街道
葵英街道	葵英街
湖熟街	湖熟街道
贸东街	贸东街道
南崴子街	南崴子街道
惠山街道	惠山街
江东街道	江东街
椒金山街	椒金山街道
金山桥街	金山桥街道
明水街道	明水街
双河街道	双河街
八一街道	八一街
广安街	广安街道
茜草街	茜草街道
榆林街	榆林街道
桃源街道	桃源街
山前街道	山前街
北城街道	北城街
百丈街	百丈街道
五里墩街	五里墩街道
兴安街	兴安街道
球场街街道	球场街
永乐街道	永乐街
新义街道	新义街
东新街	东新街道
茶山竹海街道	茶山竹海街
富民街	富民街道
东湖风景区街道	东湖风景区街
戚家山街	戚家山街道
东街	东街街道
北陶官街	北陶官街道
漳港街道	漳港街
七里甸街道	七里甸街
南芬街道	南芬街
永兴街	永兴街道
东兴街道	东兴街
世回尧街	世回尧街道
南湖街道	南湖街
民主街道	民主街
洛龙街道	洛龙街
文化街道	文化街
西丽街道	西丽街
立志街道	立志街
佳南街道	佳南街
河西街道	河西街
同和街道	同和街
石帆街道	石帆街
梅龙街道	梅龙街
关山街道	关山街
向阳街道	向阳街
水南街道	水南街
古槐街	古槐街道
昆阳街道	昆阳街
昭明街道	昭明街
大渔街道	大渔街
土坝孜街	土坝孜街道
石桥铺街道	石桥铺街
海垦街道	海垦街
西脑包街	西脑包街道
天马山街	天马山街道
八道湾街道	八道湾街
永宁街道	永宁街
双桂街道	双桂街
段庄街道	段庄街
大连湾街道	大连湾街
甘岸街道	甘岸街
白芨沟街道	白芨沟街
营海街道	营海街
新柳街道	新柳街
临海童街	临海童街道
锦湖街	锦湖街道
簇桥街道	簇桥街
仙降街道	仙降街
枫林街道	枫林街
西苑街	西苑街道
先锋街道	先锋街
嵩阳街道	嵩阳街
东街	东街街道
庆云街道	庆云街
杆石桥街道	杆石桥街
民主街道	民主街
沙河街道	沙河街
新华街道	新华街
金园街道	金园街
青园街道	青园街
安吉街	安吉街道
玉琳路街道	玉琳路街
城关街道	城关街
新华街道	新华街
秦岭路街道	秦岭路街
东山街	东山街道
古宋街道	古宋街
花洲街道	花洲街
汇通街道	汇通街
茅家岭街道	茅家岭街
培英街	培英街道
市中街道	市中街
银浪街道	银浪街
海州街道	海州街
静兰街道	静兰街
田家会街道	田家会街
即墨路街	即墨路街道
光明路街道	光明路街
矿山集街道	矿山集街
正阳街	正阳街道
中市街	中市街道
朝阳街	朝阳街街道
南湖街道	南湖街
纤维街道	纤维街
新港街道	新港街
阜桥街道	阜桥街
达活泉街道	达活泉街
新城子街道	新城子街
马泉街	马泉街道
凤凰街	凤凰街道
长乐中路街道	长乐中路街
黄河东路街道	黄河东路街
周陵街	周陵街道
玉阳街道	玉阳街
宝塔路街道	宝塔路街
广华街道	广华街
文化街街道	文化街
治淮街道	治淮街
薛家岛街道	薛家岛街
龙城街	龙城街道
冯格庄街道	冯格庄街
南楼街道	南楼街
兴隆巷街	兴隆巷街道
兴盛街道	兴盛街
马路东街	马路东街道
云池街道	云池街
文政街	文政街道
凤凰街	凤凰街道
东城街	东城街道
环城北路街道	环城北路街
浦东街道	浦东街
北街	北街街道
兴隆街	兴隆街道
凤凰山街	凤凰山街道
孝义街道	孝义街
龙门街道	龙门街
龙山街	龙山街道
广饶街道	广饶街
右安门街	右安门街道
八角街道	八角街
横泾街道	横泾街
白石江街	白石江街道
双东镇街道	双东镇街
百官街	百官街道
新华北路街道	新华北路街
市桥街道	市桥街
临江街道	临江街
中市街	中市街道
石井坡街	石井坡街道
小海街	小海街道
龙泉街	龙泉街道
城关街道	城关街
城南街	城南街道
洪山街道	洪山街
北京街道	北京街
宁园街道	宁园街
中山路街	中山路街道
望龙门街道	望龙门街
红阳街	红阳街道
城中街道	城中街
东洲街道	东洲街
民主街道	民主街
宜城路街	宜城路街道
书院路街道	书院路街
上马墩街道	上马墩街
海安街	海安街道
凤凰街	凤凰街道
新华街道	新华街
开发区龙泉街道	开发区龙泉街
板石街道	板石街
三平路街道	三平路街
小金口街道	小金口街
新村街道	新村街
昆工路街道	昆工路街
沙锅屯街	沙锅屯街道
金关街道	金关街
进学街道	进学街
东郊办事处
长青街道	长青街
康安街	康安街道
柴村街	柴村街道
玉新街道	玉新街
东关街道	东关街
大院街道	大院街
龙景街	龙景街道
体育中心街道	体育中心街
敦化坊街道	敦化坊街
田镇街道	田镇街
安埠街道	安埠街
新港街道	新港街
鼓楼街	鼓楼街道
大坝路街道	大坝路街
矿泉街	矿泉街道
后洲街道	后洲街
文昌路街	文昌路街道
南城街道	南城街
梅园街	梅园街道
百善街道	百善街
江北街	江北街道
雨山街道	雨山街
桥南街道	桥南街
沈家营街道	沈家营街
团结路街道	团结路街
梅村街道	梅村街
双塔街道	双塔街
李园街道	李园街
新安江街	新安江街道
浯溪街道	浯溪街
蓝田街道	蓝田街
帽盔山街道	帽盔山街
海东街道	海东街
流沙东街道	流沙东街
北城街道	北城街
河门口街	河门口街道
东沙街	东沙街道
兴隆街	兴隆街道
大十字街	大十字街道
天成街道	天成街
黑林铺街道	黑林铺街
九里堤街	九里堤街道
新前街	新前街道
东山街	东山街道
建安街道	建安街
板桥街道	板桥街
宁武县街	宁武县街道
东风路街	东风路街道
密地街	密地街道
茶店子街道	茶店子街
昆北街	昆北街道
江北街	江北街道
杨家岩街	杨家岩街道
霍里街道	霍里街
钓鱼台街道	钓鱼台街
山北街	山北街道
长庆街道	长庆街
后宅街道	后宅街
乌马河街	乌马河街道
正阳区街	正阳区街道
泰山路街	泰山路街道
麒麟街道	麒麟街
对炉街	对炉街道
中桥街	中桥街道
六里山街道	六里山街
锦铁街道	锦铁街
徐家楼街道	徐家楼街
陶然亭街	陶然亭街道
兴隆街	兴隆街道
龙泉街	龙泉街道
园林街道	园林街
新兴街	新兴街道
横店街道	横店街
新桥街	新桥街道
江北城街道	江北城街
双水碾街道	双水碾街
焦西街	焦西街道
新庄孜街道	新庄孜街
南纬路街	南纬路街道
津桥街	津桥街道
新市区街	新市区街道
枣林街道	枣林街
泡崖街	泡崖街道
资溪街道	资溪街
礐石街道	礐石街
普吉街道	普吉街
跳蹬河街	跳蹬河街道
北站东路街道	北站东路街
龙蟠街道	龙蟠街
大光路街	大光路街道
杏花岭街	杏花岭街道
铜沛街道	铜沛街
许庄街	许庄街道
菊园新区
亚运村街	亚运村街道
太华路街道	太华路街
五凤街道	五凤街
凤翔街道	凤翔街
利民街	利民街道
暖泉街道	暖泉街
向阳街道	向阳街
联和街道	联和街
河东街	河东街道
东兴街道	东兴街
太原街	太原街街道
北辛街道	北辛街
陶家渡街	陶家渡街道
秋江街道	秋江街
锦水街道	锦水街
猴嘴街道	猴嘴街
华龙街道	华龙街
宅吉路街	宅吉路街道
新安街道	新安街
和平南街道	和平南街
青山镇街道	青山镇街
电厂街	电厂街道
北下关街	北下关街道
东肖街	东肖街道
天中街道	天中街
盘城街道	盘城街
南汇街	南汇街道
太平桥街道	太平桥街
新城街道	新城街
古牧地西路街	古牧地西路街道
勐焕街	勐焕街道
望麓园街	望麓园街道
索镇街道	索镇街
北环路街	北环路街道
仁和街道	仁和街
王封街道	王封街
康山街	康山街道
好生街道	好生街
南长山街道	南长山街
士英街道	士英街
新埠街道	新埠街
火车站街	火车站街道
先锋街道	先锋街
官渡街道	官渡街
甘泉路街	甘泉路街道
东风街	东风街道
九矿广场街道	九矿广场街
萨尔图街道	萨尔图街
大华街道	大华街
红卫路街道	红卫路街
城关街道	城关街
五里桥街	五里桥街道
西长安街	西长安街街道
太平街	太平街道
临江街道	临江街
大连路街道	大连路街
城西街	城西街道
渔洲坪街	渔洲坪街道
朱村街	朱村街道
沱河街道	沱河街
宁海街	宁海街道
芥园街	芥园街道
西门街	西门街道
海龙街	海龙街道
新明楼街道	新明楼街
天水街道	天水街
中苑街道	中苑街
七街	七道街道
太平街	太平街道
富兴街道	富兴街
九垄地街	九垄地街道
梅华街道	梅华街
陈王街道	陈王街
六街街道	六街
龙山路街	龙山路街道
江北街	江北街道
雪浪街	雪浪街道
化客头街	化客头街道
濂溪街	濂溪街道
邢侗街道	邢侗街
南市街道	南市街
香屯街	香屯街道
田屯街道	田屯街
梧田街	梧田街道
未央宫街	未央宫街道
洗煤街道	洗煤街
天目西路街道	天目西路街
新街口街道	新街口街
骅西街道	骅西街
河北路街	河北路街道
长寿路街	长寿路街道
菊园街道	菊园街
永定路街	永定路街道
西湾街道	西湾街
越溪街	越溪街道
永昌街	永昌街道
中长街道	中长街
黄岛街道	黄岛街
红钢城街道	红钢城街
河滨街道	河滨街
辛寨子街	辛寨子街道
城东街道	城东街
建设北街	建设北街街道
杏山街	杏山街道
横岗街道	横岗街
青石山街道	青石山街
东城街	东城街道
草铺街道	草铺街
泰丰街道	泰丰街
富力街道	富力街
流花街	流花街道
七一路街	七一路街道
新建路街	新建路街道
龙湖街	龙湖街道
建兰路街	建兰路街道
浦沿街	浦沿街道
金厦街	金厦街道
大境门街道	大境门街
冯家街道	冯家街
胡桥街道	胡桥街
五星街道	五星街
河西街道	河西街
武穴街道	武穴街
娄桥街道	娄桥街
各塔埠街道	各塔埠街
大石街道	大石街
新地号街道	新地号街
甸柳街道	甸柳街
建桥街街道	建桥街
杏林街	杏林街道
柏亭街道	柏亭街
大有坊街道	大有坊街
前进街	前进街道
零口街道	零口街
翠园街	翠园街道
三官殿街道	三官殿街
京城街	京城街道
城北新区街道	城北新区街
东盛街道	东盛街
恩城街	恩城街道
卓刀泉街道	卓刀泉街
金石滩街	金石滩街道
沈家门街道	沈家门街
文苑街	文苑街道
五马街道	五马街
上兰街道	上兰街
浣东街	浣东街道
港湾街道	港湾街
蔡子池街	蔡子池街道
东方街	东方街道
黄海路街道	黄海路街
新区街	新区街道
龙城街	龙城街道
西水街道	西水街
山头街道	山头街
西湖路街道	西湖路街
城关街道	城关街
五龙街	五龙街道
大宝鼎街道	大宝鼎街
盐津街	盐津街道
南钢街道	南钢街
和平街道	和平街
邻玉街道	邻玉街
爵溪街	爵溪街道
东风路街	东风路街道
磐东街	磐东街道
和平桥街	和平桥街道
南禅寺街道	南禅寺街
新兴街	新兴街道
中洲街	中洲街道
车城路街	车城路街道
济源路街	济源路街道
月浦街道	月浦街
南石头街道	南石头街
前卫街	前卫街道
渭源路街道	渭源路街
育才街道	育才街
炉院街	炉院街街道
圣井街	圣井街道
石岐区街	石岐区街道
桐城街道	桐城街
都拉营街道	都拉营街
盈浦街道	盈浦街
天马街道	天马街
七里店街	七里店街道
彭李街道	彭李街
建民街道	建民街
女埠街道	女埠街
安乐街道	安乐街
平安街道	平安街
南戴河街	南戴河街道
赛虹桥街	赛虹桥街道
江苏路街	江苏路街道
古泉街	古泉街道
小谷围街道	小谷围街
西关街	西关街街道
江宁路街	江宁路街道
文化街道	文化街
公园街道	公园街
大营门街	大营门街道
厂前街道	厂前街
毓璜顶街	毓璜顶街道
桥西街道	桥西街
振头街道	振头街
首义路街道	首义路街
北城街道	北城街
浮桥街道	浮桥街
仙华街	仙华街道
幸福路街道	幸福路街
密州街	密州街道
东方街	东方街道
今是街道	今是街
东环街道	东环街
阜新路街	阜新路街道
望岳街	望岳街道
南院门街	南院门街道
塘尾街道	塘尾街
黄鹤楼街	黄鹤楼街道
鱼化寨街道	鱼化寨街
月山街道	月山街
中南街道	中南街
上塘街道	上塘街
嘉北街	嘉北街道
大庆路街道	大庆路街
新建路街	新建路街道
和平路街道	和平路街
万松街街道	万松街
西藏路街	西藏路街道
千泉街道	千泉街
北陵街道	北陵街
江海街	江海街道
岳程街	岳程街道
东街	东街街道
茶园街道	茶园街
秀山街道	秀山街
新城街道	新城街
镇溪街道	镇溪街
东四街道	东四街
新东街	新东街道
鹿楼街道	鹿楼街
新胜街	新胜街道
九龙街道	九龙街
徐杨街道	徐杨街
向上街道	向上街
新园街	新园街道
海滨路街	海滨路街道
航海西路街	航海西路街道
利津街道	利津街
永定门外街道	永定门外街
枫桥街	枫桥街道
吉舒街道	吉舒街
德胜街道	德胜街
中兴路街道	中兴路街
无瑕街	无瑕街道
桃园街	桃园街道
唐冶街道	唐冶街
塔湾街	塔湾街道
马桥街道	马桥街
崇文门外街道	崇文门外街
多宝街道	多宝街
友好北路街	友好北路街道
段塘街道	段塘街
沟口街道	沟口街
碱场街道	碱场街
学院南路街	学院南路街道
嘉禾街	嘉禾街道
丰年村街	丰年村街道
东城街	东城街道
紫水街	紫水街道
新街街道	新街
临江街道	临江街
周庄街	周庄街道
西宁路街	西宁路街道
西湖景区街道	西湖景区街
山美街	山美街道
绣林街道	绣林街
魏塘街	魏塘街道
南城街道	南城街
鸭塘街道	鸭塘街
河南街道	河南街
行者街道	行者街
苏海图街道	苏海图街
二堰街	二堰街道
沽河街	沽河街道
南珠街	南珠街道
双河街道	双河街
西坞街道	西坞街
中华路街	中华路街道
斥山街道	斥山街
剑南街	剑南街道
凤凰山街	凤凰山街道
临齐街	临齐街道
西厂门街	西厂门街道
景山街	景山街道
沿江街	沿江街道
龙华街	龙华街道
万新街	万新街道
东山街	东山街道
交流岛街	交流岛街道
昆明街	昆明街道
城东街道	城东街
蜀北街道	蜀北街
笔架山街道	笔架山街
新工街	新工街道
龙山街	龙山街道
南山街	南山街道
梓潼街	梓潼街道
丹赵路街	丹赵路街道
府后街街道	府后街
东屯渡街道	东屯渡街
崇文街	崇文街道
城东街道	城东街
城厢街道	城厢街
搭连街道	搭连街
桥南街道	桥南街
伍家岭街道	伍家岭街
鱼洞街	鱼洞街道
新华街道	新华街
二界沟街道	二界沟街
星火街道	星火街
建设街道	建设街
棘洪滩街道	棘洪滩街
建设街道	建设街
艳山红街道	艳山红街
东关街道	东关街
铃铛阁街道	铃铛阁街
太行街	太行街道
文教街	文教街道
清水台街	清水台街道
柏林庄街道	柏林庄街
白沙湾街	白沙湾街道
长丰街	长丰街道
龙虎塘街道	龙虎塘街
南滩街	南滩街道
龙潭街道	龙潭街
南沙街	南沙街道
河西街道	河西街
东湖街	东湖街道
河婆街道	河婆街
工程街	工程街道
关口街	关口街道
福莱山街	福莱山街道
晋华街道	晋华街
大栗子街道	大栗子街
新江湾城街道	新江湾城街
干河陈街道	干河陈街
维明街	维明街道
钟鼓楼街道	钟鼓楼街
城北街	城北街道
兆麟街	兆麟街道
保安街道	保安街
秀江街道	秀江街
三里河街道	三里河街
南郊街道	南郊街
双岗街道	双岗街
张家村街	张家村街道
青花街道	青花街
天河街道	天河街
南阳街道	南阳街
新开河街	新开河街道
新兴街	新兴街道
大定街道	大定街
文庙街	文庙街道
鼓楼街	鼓楼街道
前进道街道	前进街
拥政街道	拥政街
湘湖街道	湘湖街
头桥街道	头桥街
南街	南街街道
国基路街	国基路街道
忙畔街道	忙畔街
向阳街道	向阳街
南华街道	南华街
万青路街道	万青路街
沙岭街道	沙岭街
瑞金二路街道	瑞金二路街
鹅山街道	鹅山街
保平街	保平街道
宁华路街道	宁华路街
朝阳街	朝阳街道
京溪街道	京溪街
万里街道	万里街
水上公园街道	水上公园街
火星街道	火星街
浴新南街	浴新南街道
中山路街	中山路街道
泉水街道	泉水街
南站街	南站街道
天桥街道	天桥街
白洋湾街道	白洋湾街
那洪街道	那洪街
兴华路街	兴华路街道
李家沱街	李家沱街道
东山街	东山街道
大兴街道	大兴街
长白街道	长白街
头二三街	头二三街道
新屯街道	新屯街
纳尔巴格街道	纳尔巴格街
望京街	望京街道
宋门街道	宋门街
东安街	东安街道
双王街道	双王街
矿山路街	矿山路街道
洪都街道	洪都街
联盟街道	联盟街
安静街	安静街道
怀庆街道	怀庆街
舜王街道	舜王街
塔山街	塔山街道
民强街道	民强街
凌北街道	凌北街
抚顺城街道	抚顺城街
光明街	光明街道
友谊街道	友谊街
四季青街	四季青街道
中心路街	中心路街道
鹦鹉街街道	鹦鹉街
星海湾街道	星海湾街
启工街道	启工街
潭西街道	潭西街
下陈街道	下陈街
达濠街	达濠街道
乌素图街道	乌素图街
东港街道	东港街
风采街	风采街道
张家堡街	张家堡街道
市东街	市东街道
上望街	上望街道
建设路街道	建设路街
王石凹街道	王石凹街
清安街道	清安街
十里铺街道	十里铺街
焦南街	焦南街道
新城街道	新城街
寿泉街	寿泉街道
淮川街道	淮川街
西林街	西林街道
上站街道	上站街
广场街道	广场街
长和廊街	长和廊街道
群众路街道	群众路街
平岗街道	平岗街
花山街	花山街道
建设街道	建设街
西海街	西海街道
双龙湖街	双龙湖街道
苇湖梁街道	苇湖梁街
岳阳街	岳阳街道
福溪街道	福溪街
松北街	松北街道
南站街	南站街道
光明街	光明街道
小河街道	小河街
武东街道	武东街
凌云路街道	凌云路街
龙翔街道	龙翔街
湖滨街	湖滨街道
夏庄街道	夏庄街
永丰路街道	永丰路街
金家庄街	金家庄街道
奋斗路街	奋斗路街道
鲁谷街	鲁谷街道
长宁街	长宁街道
荷花路街	荷花路街道
南市街道	南市街
红山街道	红山街
永兴街	永兴街道
望海楼街道	望海楼街
潘桥街	潘桥街道
杨家坪街道	杨家坪街
盐湖街道	盐湖街
井湾子街	井湾子街道
张甸街道	张甸街
康宁街	康宁街道
荆西街	荆西街道
太平街	太平街道
姚集街道	姚集街
港沟街	港沟街道
科尔沁街	科尔沁街道
交通街道	交通街
城南街	城南街道
立山街道	立山街
广安门内街道	广安门内街
李台街	李台街道
南山街	南山街道
南关街道	南关街
灵泉寺街道	灵泉寺街
芝罘岛街道	芝罘岛街
九里山街道	九里山街
杨家峪街	杨家峪街道
老西门街	老西门街道
卸甲甸街道	卸甲甸街
东站街	东站街道
新建街	新建街道
凤凰岭街	凤凰岭街道
海棠街	海棠街道
怡园街道	怡园街
池尾街道	池尾街
北京路街	北京路街道
南苑街	南苑街道
三叉街街道	三叉街
桃源街道	桃源街
城西街	城西街道
黄务街	黄务街道
新建街	新建街道
云杉路街	云杉路街道
海门街	海门街道
韦岗街	韦岗街道
六角亭街道	六角亭街
南关岭街道	南关岭街
昆吾路街	昆吾路街道
音西街道	音西街
兴化街	兴化街道
锦南街	锦南街道
光明路街道	光明路街
集里街道	集里街
古渡街	古渡街道
纱帽街道	纱帽街
南泉街	南泉街道
关东街	关东街道
丽园街	丽园街道
锦郊街道	锦郊街
燕山街道	燕山街
南调街道	南调街
东城街	东城街道
王顶堤街	王顶堤街道
广场街道	广场街
三涧堡街	三涧堡街道
向阳街道	向阳街
瓜子坪街道	瓜子坪街
刘集街道	刘集街
城厢街道	城厢街
富源路街	富源路街道
凤凰街	凤凰街道
电厂路街道	电厂路街
新新街街道	新新街
龚家寨街	龚家寨街道
工人村街道	工人村街
培黎街	培黎街道
大恒山街	大恒山街道
南浦街道	南浦街
大德恒街	大德恒街道
湖滨路街	湖滨路街道
迎泽街道	迎泽街
大桥街道	大桥街
台吉街道	台吉街
旧城区街	旧城区街道
新陶官街道	新陶官街
柳林桥街道	柳林桥街
露峰街道	露峰街
南塔街道	南塔街
新华街	新华街街道
东关街道	东关街
舞阳坝街道	舞阳坝街
桥东街道	桥东街
凤凰街	凤凰街道
城南街	城南街道
莲花池街	莲花池街道
青菏街道	青菏街
紫云街道	紫云街
南大街街道	南大街
东街	东街街道
儒林街道	儒林街
果园新村街道	果园新村街
文化路街道	文化路街
三十里堡街道	三十里堡街
南岸街	南岸街道
燕西街道	燕西街
民航路街	民航路街道
筠阳街道	筠阳街
财落街道	财落街
龙山街	龙山街道
友谊街道	友谊街
振兴街道	振兴街
新华西路街道	新华西路街
上河街	上河街道
梦芝街道	梦芝街
垡头街道	垡头街
七甸街道	七甸街
工农街道	工农街
南阳路街	南阳路街道
中仓街	中仓街道
南环中路街	南环中路街道
梁山街	梁山街道
咸阳北路街道	咸阳北路街
太和桥街	太和桥街道
长兴街道	长兴街
菊花街道	菊花街
五里沟街道	五里沟街
夏都街道	夏都街
铁路东街道	铁路东街
郑家屯街道	郑家屯街
海滨街	海滨街道
武宁街道	武宁街
革镇堡街	革镇堡街道
中山街道	中山街
东郊街道	东郊街
鲤中街道	鲤中街
嵩山路街	嵩山路街道
王曲街道	王曲街
巴音赛街道	巴音赛街
新区街	新区街道
葑门街道	葑门街
县桥街道	县桥街
东皇街道	东皇街
城北街	城北街道
新港街道	新港街
城东湖街	城东湖街道
吉崩岗街	吉崩岗街道
鼓楼街	鼓楼街道
迈皋桥街	迈皋桥街道
银盆岭街	银盆岭街道
城东街道	城东街
簇锦街道	簇锦街
滘北街道	滘北街
丹桂街道	丹桂街
荆溪街道	荆溪街
曙光街	曙光街道
下窑街道	下窑街
光塔街道	光塔街
毕家岗街	毕家岗街道
社建村街	社建村街道
热水汤街	热水汤街道
水泊街道	水泊街
龙桥街道	龙桥街
覃家岗街道	覃家岗街
铁路西村街道	铁路西村街
阳明街道	阳明街
真源街	真源街道
友谊街道	友谊街
东广街道	东广街
河南街道	河南街
蒲北街道	蒲北街
常青街	常青街道
福田街	福田街道
白塘街道	白塘街
红军街	红军街道
露天矿街道	露天矿街
永昌街	永昌街道
洛羊街道	洛羊街
五里牌街	五里牌街道
兴长路街道	兴长路街
新春街	新春街道
太行小区街道	太行小区街
西柳沟街	西柳沟街道
北城街道	北城街
龙须塘街道	龙须塘街
京泰路街	京泰路街道
油榨街街道	油榨街
第二街道	第二街
大山江街	大山江街道
徐圩街道	徐圩街
北塔街道	北塔街
文峰街	文峰街道
星海街	星海街道
泾川县街道	泾川县街
新城街道	新城街
艾山街道	艾山街
亮甲店街道	亮甲店街
龙坪街道	龙坪街
黄屯街道	黄屯街
新沟桥街	新沟桥街道
彭家桥街道	彭家桥街
源西街道	源西街
梁山街	梁山街道
梅溪街	梅溪街道
北大街	北大街道
燕塔街道	燕塔街
皮口街道	皮口街
云南路街	云南路街道
大谭街道	大谭街
新市场街	新市场街道
三里庵街	三里庵街道
五营街道	五营街
双凤桥街	双凤桥街道
人民路街道	人民路街
东茅岭街道	东茅岭街
凉高山街	凉高山街道
太阳街	太阳街道
城东街道	城东街
乌龙泉街道	乌龙泉街
清真巷街道	清真巷街
七里山街道	七里山街
远达街	远达街道
纬二路街道	纬二路街
公明街	公明街道
姚孟街道	姚孟街
孙家堡子街	孙家堡子街道
朱村街	朱村街道
海伦路街道	海伦路街
城西街	城西街道
龙都街道	龙都街
大孤山街道	大孤山街
华强街道	华强街
双福街道	双福街
定和街	定和街道
东城街	东城街道
柳树街街道	柳树街
凤城街	凤城街道
新开路街道	新开路街
高新区紫贞街道	高新区紫贞街
民权街道	民权街
幸福路街道	幸福路街
晏城街道	晏城街
芝麻墩街	芝麻墩街道
飞英街道	飞英街
农林街道	农林街
缸窑街道	缸窑街
盐盆街道	盐盆街
三道坎街道	三道坎街
月坛街道	月坛街
下应街	下应街道
兴隆台街道	兴隆台街
东高皇街	东高皇街道
北山街	北山街道
南直路街	南直路街道
果园街道	果园街
古冶街	古冶街道
兴建路街	兴建路街道
广澳街道	广澳街
北城街道	北城街
清洋街	清洋街道
林荫路街	林荫路街道
瓯宁街	瓯宁街道
四龙路街道	四龙路街
太平湾街	太平湾街道
美林街	美林街道
新民路街	新民路街道
东外街	东外街道
艳粉街道	艳粉街
回兴街道	回兴街
四方街道	四方街
土门墩街道	土门墩街
黄石街道	黄石街
森工路街道	森工路街
留下街道	留下街
清河街	清河街道
金银山街道	金银山街
新华路街	新华路街道
东大街道	东大街
临汾路街	临汾路街道
北湖管委会街	北湖管委会街道
五桂山街	五桂山街道
清河街	清河街道
天苑街	天苑街道
北门街	北门街道
白沙街道	白沙街
芦岗街	芦岗街道
杜别克街道	杜别克街
梅溪湖街	梅溪湖街道
长西街	长西街道
古牧地东路街	古牧地东路街道
团结大街街道	团结大街
东海街道	东海街
第五街道	第五街
中山南街街道	中山南街
盐场路街	盐场路街道
东风街	东风街道
景泰街	景泰街道
建国街街道	建国街
四宝山街	四宝山街道
城南街	城南街道
火车头街	火车头街道
乌兰街	乌兰街道
四马路街道	四马路街
新湘路街道	新湘路街
沿海街	沿海街道
孝陵卫街	孝陵卫街道
凤凰街	凤凰街道
奶子山街道	奶子山街
稻香村街	稻香村街道
东城街	东城街道
华山街道	华山街
龙华街	龙华街道
华阳路街	华阳路街道
同益街道	同益街
清和街道	清和街
桥中街	桥中街道
韩城街	韩城街道
石东路街道	石东路街
朝阳街	朝阳街道
前进街	前进街道
广卫街道	广卫街
文亭街道	文亭街
桐君街道	桐君街
杭盖街道	杭盖街
创业街道	创业街
北大街街道	北大街
潭中街	潭中街道
鹿山街	鹿山街道
展览路街道	展览路街
石拐街道	石拐街
彰北街道	彰北街
阳三街道	阳三街
和顺街道	和顺街
德宽路街道	德宽路街
东湖街	东湖街道
翁垟街	翁垟街道
仓埠街道	仓埠街
武湖街	武湖街道
三堤口街道	三堤口街
花山街	花山街道
青年路街	青年路街道
中山东路街道	中山东路街
流沙西街	流沙西街道
五里坨街道	五里坨街
太平街	太平街道
城南街	城南街道
石化路街道	石化路街
璧城街道	璧城街
五里牌街	五里牌街道
南关街道	南关街
福应街道	福应街
德胜街道	德胜街
大田街	大田街道
官园街	官园街道
五角场街道	五角场街
半拉山街	半拉山街道
石门二路街	石门二路街道
浒山街道	浒山街
双龙街	双龙街道
青园街道	青园街
黄花岗街道	黄花岗街
岳庙街道	岳庙街
新阳街道	新阳街
悦来街道	悦来街
东辛房街道	东辛房街
钧台街	钧台街道
岭南街道	岭南街
淮海中路街道	淮海中路街
新村街道	新村街
皇甫路街	皇甫路街道
万盛街道	万盛街
东街道	东街
彰武街道	彰武街
碱泉街	碱泉街道
南七街道	南七街
广文街	广文街道
万丈湖街	万丈湖街道
前进街	前进街道
庙前街道	庙前街
马场街道	马场街
高里街	高里街道
五老屯街	五老屯街道
曹城街	曹城街道
美溪街道	美溪街
青湖路街道	青湖路街
矿山街	矿山街道
建设街道	建设街
滕王阁街	滕王阁街道
拥军街	拥军街道
育才街道	育才街
洗马河街道	洗马河街
梅沙街道	梅沙街
乡贤街	乡贤街街道
东区街道	东区街
凤凰街	凤凰街道
铁炉街	铁炉街道
天宫院街道	天宫院街
北苑街	北苑街道
南城街道	南城街
相台街道	相台街
邙岭路街	邙岭路街道
新城街道	新城街
新华路街	新华路街道
前进街	前进街道
高米店街道	高米店街
柳影街道	柳影街
临沭街道	临沭街
桂溪街	桂溪街道
棉纺路街	棉纺路街道
冲口街	冲口街道
金口路街道	金口路街
古楼街道	古楼街
八家子街	八家子街道
北新桥街道	北新桥街
新安街道	新安街
安宁堡街道	安宁堡街
致和街道	致和街
健康路街道	健康路街
庄市街道	庄市街
向阳街道	向阳街
桂山街道	桂山街
高资街	高资街道
梅山街道	梅山街
罗城头街	罗城头街道
桃源街道	桃源街
店张街	店张街道
灵泉街道	灵泉街
官渡街道	官渡街
枣园街	枣园街道
燎原街	燎原街道
义井街道	义井街
齐陵街	齐陵街道
山东庙街	山东庙街道
狼山镇街道	狼山镇街
龙岗街	龙岗街道
陈相街道	陈相街
新抚街	新抚街道
金竹街	金竹街道
鹿阜街道	鹿阜街
梅岭街	梅岭街道
蓝田街道	蓝田街
湖东路街	湖东路街道
汪家街道	汪家街
跃进村街道	跃进村街
南苑街	南苑街道
葵涌街道	葵涌街
稀土路街道	稀土路街
建设街道	建设街
广开街	广开街道
南湖街道	南湖街
钢铁路街道	钢铁路街
江心洲街道	江心洲街
花桥街	花桥街街道
萝岗街道	萝岗街
龙滩子街道	龙滩子街
小营街道	小营街
湾溪街道	湾溪街
三里屯街道	三里屯街
南城区街	南城区街道
江南中街	江南中街道
启明街道	启明街
冷水江街	冷水江街道
皮山县街道	皮山县街
东陵街道	东陵街
柴河街道	柴河街
老山街	老山街道
迎宾街	迎宾街道
宝西街道	宝西街
城南街	城南街道
新华路街	新华路街道
同和街道	同和街
北城街道	北城街
新兴街	新兴街道
金城街	金城街道
新汶街道	新汶街
龙山街	龙山街道
蛇口街道	蛇口街
通泰街道	通泰街
凤山街	凤山街道
河滨路街	河滨路街道
开元街道	开元街
阳逻街	阳逻街道
铁路街	铁路街道
新城区街	新城区街道
团城山街	团城山街道
北街	北街街道
小溪塔街	小溪塔街道
沙坪街道	沙坪街
陈桥街	陈桥街道
高坡街	高坡街街道
广德寺街	广德寺街道
都昌街道	都昌街
双江街道	双江街
宛水街	宛水街道
英雄街道	英雄街
潘黄街	潘黄街道
中星街道	中星街
新盛街道	新盛街
东兴街道	东兴街
桥头街道	桥头街
西司门街道	西司门街
谢家湾街道	谢家湾街
汤头街道	汤头街
鼓楼街	鼓楼街道
嘉兴路街道	嘉兴路街
南城街道	南城街
罗星街	罗星街道
长安街	长安街道
沈采街道	沈采街
扬名街道	扬名街
平台街道	平台街
太升路街	太升路街道
东风街	东风街道
金龙镇街	金龙镇街道
东大街街道	东大街
天衢街道	天衢街
北书店街道	北书店街
北塬街道	北塬街
北营街道	北营街
玲珑街道	玲珑街
丰乐街道	丰乐街
头道牌楼街道	头道牌楼街
光明街	光明街道
虹桥街道	虹桥街
洮府街道	洮府街
涌泉街	涌泉街道
东环街道	东环街
东城街	东城街道
北屯街	北屯街道
西大街街道	西大街
贵城街道	贵城街
石壁街道	石壁街
菜园坝街道	菜园坝街
匡远街道	匡远街
巴川街道	巴川街
高峰街道	高峰街
东城街	东城街道
五一路街	五一路街道
南苑街	南苑街道
小东街道	小东街
龙凤街道	龙凤街
东南隅街	东南隅街道
北关街道	北关街
广川街道	广川街
五泉街	五泉街道
文庙街	文庙街道
临江街道	临江街
兴丰街	兴丰街道
南纪门街	南纪门街道
福民街	福民街道
中南街道	中南街
万寿街	万寿街道
团结街	团结街道
工农街道	工农街
五堰街	五堰街道
中山路街	中山路街道
海府街道	海府街
马家店街	马家店街道
和平街道	和平街
西于庄街	西于庄街道
城正街	城正街街道
襄平街道	襄平街
东城街	东城街道
南外街道	南外街
培元街道	培元街
东城街	东城街道
西山街	西山街道
望滨街道	望滨街
大沙街	大沙街道
西塞山街	西塞山街道
青岛街	青岛街道
四台沟街	四台沟街道
赭麓街	赭麓街道
徐城街道	徐城街
启新街	启新街道
城西街	城西街道
浦兴路街	浦兴路街道
卫东街	卫东街道
大塘街	大塘街道
东风路街	东风路街道
恒源街道	恒源街
笋岗街道	笋岗街
北山街	北山街道
克尔根卓街道	克尔根卓街
城区街道	城区街
龙湾街	龙湾街道
永定庄街道	永定庄街
湘雅路街道	湘雅路街
张湾街道	张湾街
清河口街道	清河口街
向阳街道	向阳街
中心站街	中心站街道
赤岗街道	赤岗街
进乡街道	进乡街
鼓楼街	鼓楼街道
杨庄街	杨庄街道
大庆路街道	大庆路街
工农街道	工农街
尚庄街	尚庄街道
丁家街	丁家街道
东河区街道	东河区街
八泉街道	八泉街
新城街道	新城街
阳头街	阳头街道
丽景街街道	丽景街
新狮街道	新狮街
北干街道	北干街
光宇街	光宇街道
驼峰路街	驼峰路街道
解放北路街道	解放北路街
抚顺街	抚顺街道
浑河站西街道	浑河站西街
龙都街道	龙都街
建设路街道	建设路街
连岛街道	连岛街
春城街道	春城街
苏山街	苏山街道
光武街	光武街道
凤凰街	凤凰街道
宝塔山街	宝塔山街道
南关街道	南关街
华新街街道	华新街
嘉禾街	嘉禾街道
东栅街道	东栅街
金川街道	金川街
泉城路街道	泉城路街
龙凤桥街	龙凤桥街道
城南街	城南街道
文昌街道	文昌街
莲山街道	莲山街
松港街	松港街道
中枢街	中枢街道
新塘街道	新塘街
环市街道	环市街
富民路街	富民路街道
香坊大街	香坊大街街道
向阳街道	向阳街
巨野河街	巨野河街道
新镇街道	新镇街
同德街道	同德街
夏家店街道	夏家店街
文艺路街道	文艺路街
城东街道	城东街
黄沙湾街	黄沙湾街道
江湾镇街道	江湾镇街
石磷街道	石磷街
桃源街道	桃源街
造纸街道	造纸街
东关大街街道	东关大街
春柳街	春柳街道
灞桥街道	灞桥街
府南街道	府南街
新村街道	新村街
艺新街道	艺新街
三圣街道	三圣街
古塔街道	古塔街
大赵峪街道	大赵峪街
洲心街	洲心街道
马塘街	马塘街道
迎龙桥街	迎龙桥街道
建设街道	建设街
城西街	城西街道
文化街街道	文化街
钢城街道	钢城街
东门街	东门街道
张公桥街	张公桥街道
矿工路街道	矿工路街
柯桥街道	柯桥街
宗关街道	宗关街
中街街道	中街
北环路街	北环路街道
潮连街	潮连街道
吉日街道	吉日街
下五屯街	下五屯街道
石狮埠街	石狮埠街道
澧江街	澧江街道
新华街道	新华街
南街	南街街道
渭阳西路街	渭阳西路街道
站前街道	站前街
长甸街	长甸街道
凤凰城街道	凤凰城街
张湾街道	张湾街
大河路街	大河路街道
猛追湾街道	猛追湾街
丁庄街道	丁庄街
乌桥街道	乌桥街
向阳小区街道	向阳小区街
桥东街道	桥东街
东门街	东门街道
金珠西路街道	金珠西路街
鑫源街道	鑫源街
建国门街	建国门街道
松源街	松源街道
檀溪街	檀溪街道
裕民街道	裕民街
蓉江街	蓉江街道
文晖街道	文晖街
鼓楼街	鼓楼街道
河滨街道	河滨街
东厅街道	东厅街
兴隆街	兴隆街道
河北街道	河北街
西关街道	西关街
永中街	永中街道
人民街道	人民街
夏港街	夏港街道
钱营街道	钱营街
员村街道	员村街
光社街	光社街道
皋兰路街	皋兰路街道
当湖街道	当湖街
城郊街道	城郊街
崖头街道	崖头街
洋溪街道	洋溪街
四季青街	四季青街道
张贵庄街	张贵庄街道
罗州街道	罗州街
掇刀街	掇刀街道
天河南街道	天河南街
人民路街道	人民路街
友协街道	友协街
沧浪街道	沧浪街
安山街	安山街道
岳林街道	岳林街
中和街道	中和街
城区街道	城区街
流沙北街	流沙北街道
大青中朝友谊街	大青中朝友谊街道
北山街	北山街道
翠苑街道	翠苑街
富文街道	富文街
翠微街	翠微街街道
固堤街	固堤街道
龙山街	龙山街道
会兴街	会兴街道
千金街道	千金街
四家屯街道	四家屯街
龙祥街道	龙祥街
文昌街道	文昌街
阿什河街	阿什河街道
文圣街道	文圣街
兴工街道	兴工街
大良街	大良街道
琴台街	琴台街道
赵各庄街	赵各庄街道
梅云街道	梅云街
元明街道	元明街
沅江路街道	沅江路街
朝天门街道	朝天门街
石湾镇街道	石湾镇街
城南街	城南街道
红旗街道	红旗街
淮河路街	淮河路街道
界湖街	界湖街道
翔云街	翔云道街道
双吉街	双吉街道
新石街道	新石街
北街	北街街道
罗桥街道	罗桥街
珠山街道	珠山街
武汉路街道	武汉路街
玉都街道	玉都街
大众街街道	大众街
铜元局街	铜元局街道
白音席勒街道	白音席勒街
观音山街道	观音山街
二道河子街	二道河子街道
沙坪坝街道	沙坪坝街
龙山路街	龙山路街道
渚河路街	渚河路街道
新立街道	新立街
黄旗堡街	黄旗堡街道
林东东城街	林东东城街道
江川路街道	江川路街
龙湖街	龙湖街道
新城街道	新城街
上库力街	上库力街道
南城街道	南城街
新体路街道	新体路街
爱国街道	爱国街
南地街	南地街道
光辉街	光辉街道
皇城街道	皇城街
四唯街	四唯街街道
江口街道	江口街
三桥街道	三桥街
安居街道	安居街
解放门街	解放门街道
渝碚路街	渝碚路街道
三江街	三江街道
秦山街道	秦山街
隐珠街道	隐珠街
南新街	南新街街道
宁安路街	宁安路街道
新春街	新春街道
江南街	江南街道
平泉路街道	平泉路街
东平街道	东平街
海州街道	海州街
南城街道	南城街
吾斯塘博依街道	吾斯塘博依街
四褐山街道	四褐山街
葛洲坝街	葛洲坝街道
雨金街道	雨金街
新起街道	新起街
斗门街	斗门街道
东风路街	东风路街道
东升街道	东升街
宝城街道	宝城街
纺织城街	纺织城街道
德城街道	德城街
越河街	越河街道
宝塔桥街	宝塔桥街道
东关街道	东关街
官陡街道	官陡街
暨阳街道	暨阳街
中心街	中心街街道
白羽街	白羽街道
博昌街	博昌街道
东华街	东华街道
北关街道	北关街
前进街	前进街道
章村街道	章村街
南庄坪街	南庄坪街道
城阳街道	城阳街
岱庙街	岱庙街道
正阳街	正阳街道
云城街	云城街道
屏襄门街	屏襄门街道
云门山街道	云门山街
延吉新村街	延吉新村街道
城关街道	城关街
中韩街道	中韩街
陶朱街道	陶朱街
育才路街道	育才路街
幸福街道	幸福街
前进街	前进街街道
西鸡西街	西鸡西街道
上海路街	上海路街道
荷花街	荷花街道
北湖街道	北湖街
采石街道	采石街
锡矿山街	锡矿山街道
西涧街	西涧街道
西马街道	西马街
东阁街	东阁街道
桃蹊路街道	桃蹊路街
通道街街道	通街
东山街	东山街道街道
城南街	城南街道
麻斜街	麻斜街道
井口街	井口街道
城北街	城北街道
文庙街	文庙街道
连湾街	连湾街道
翠竹街道	翠竹街
曹杨新村街	曹杨新村街道
紫荆山南路街	紫荆山南路街道
杏花街	杏花街道
荣军街	荣军街道
李七庄街道	李七庄街
莲华街道	莲华街
双山街	双山街道
十字路街	十字路街道
唐塔街	唐塔街道
拉布达林街道	拉布达林街
金星街	金星街道
黄岗街道	黄岗街
温泉街	温泉街道
曹溪街道	曹溪街
老平旺街道	老平旺街
渠东街	渠东街道
洎阳街道	洎阳街
凤凰岭街	凤凰岭街道
红岛街	红岛街道
何坊街	何坊街道
湘龙街道	湘龙街
康健新村街道	康健新村街
双丰街	双丰街道
北门街	北门街道
溪北街道	溪北街
牌楼街道	牌楼街
环翠楼街	环翠楼街道
光明西街	光明西道街道
任楼街	任楼街道
西关街道	西关街
砂子塘街道	砂子塘街
金浦街	金浦街道
四川北路街	四川北路街道
坛山街道	坛山街
环城街道	环城街
杏南街	杏南街道
文昌街道	文昌街
闻韶街道	闻韶街
凤里街道	凤里街
电力路街	电力路街道
西马街	西马街街道
唐口街道	唐口街
建筑街道	建筑街
新东街	新东街道
新北街道	新北街
华庄街道	华庄街
庞村街道	庞村街
东关街道	东关街
东升区街	东升区街道
彩屯街	彩屯街道
坪山街道	坪山街
城北路街道	城北路街
康金街	康金街道
岭北街道	岭北街
虬江街道	虬江街
九龙街道	九龙街
澄华街	澄华街道
延安南路街道	延安南路街
梁苑街	梁苑街道
赛鱼街	赛鱼街道
岩泉街	岩泉街道
新新街道	新新街
古田街	古田街道
龙山街	龙山街道
新兴街	新兴街道
水清沟街	水清沟街道
洪庆街道	洪庆街
子房街道	子房街
新建南路街道	新建南路街
惠民街道	惠民街
松山街道	松山街
义城街	义城街道
菜市街道	菜市街
九曲街	九曲街道
新碶街道	新碶街
楚古兰街道	楚古兰街
兴安街	兴安街道
阳和街	阳和街道
空港街道	空港街
杨文街道	杨文街
建昌街	建昌道街道
回龙河街道	回龙河街
石油新村街道	石油新村街
张庙街道	张庙街
干河街	干河街道
鼓楼街	鼓楼街道
崇义街	崇义街道
旌阳街道	旌阳街
城东街道	城东街
白水湖街道	白水湖街
新洋街道	新洋街
五里亭街	五里亭街道
胜利街	胜利街道
紫荆路街道	紫荆路街
和平路街道	和平路街
东铺头街道	东铺头街
三甲街道	三甲街
龙门石窟街道	龙门石窟街
北关街道	北关街
央子街	央子街道
菱角山街道	菱角山街
朝歌街道	朝歌街
宋家塘街	宋家塘街道
光明桥街道	光明桥街
豆腐营街	豆腐营街道
岱山街	岱山街道
万安街	万安街道
舍利街道	舍利街
汪集街道	汪集街
下瓦房街道	下瓦房街
明德北街街道	明德北街
玉皇阁北街街道	玉皇阁北街
小召前街	小召前街街道
龙旺庄街道	龙旺庄街
双桥街道	双桥街
坑口街道	坑口街
西营城街道	西营城街
三洞桥街道	三洞桥街
梧桐街	梧桐街道
白云路街	白云路街道
宝平街	宝平街道
河北街道	河北街
洪桥街道	洪桥街
坎墩街道	坎墩街
鲁城街	鲁城街道
新津街	新津街道
学苑街道	学苑街
大嶝街道	大嶝街
曹门街道	曹门街
桐屿街道	桐屿街
金口街道	金口街
席王街	席王街道
橡林街	橡林街道
八仙桥街	八仙桥街道
燕子矶街	燕子矶街道
竹峰街道	竹峰街
黄陵街道	黄陵街
汶河街道	汶河街
九水路街道	九水路街
廿三里街道	廿三里街
桂园街道	桂园街
西南街	西南街道
高桥街	高桥街道
东方广场街	东方广场街道
于家堡街	于家堡街道
杏园街道	杏园街
田村路街	田村路街道
春和街道	春和街
长安街	长安街道
库木德尔瓦扎街道	库木德尔瓦扎街
清江街道	清江街
新嘉街道	新嘉街
海滨街	海滨街道
国兴街道	国兴街
昱中街道	昱中街
文家街道	文家街
昌洲街道	昌洲街
大石桥街道	大石桥街
兴安街	兴安街道
当周街道	当周街
定城街道	定城街
八一街	八一街街道
江宁街	江宁街道
忻州窑街	忻州窑街道
石洞街道	石洞街
马庄街道	马庄街
锁金村街道	锁金村街
溪美街道	溪美街
苏仙岭街	苏仙岭街道
瑞金路街道	瑞金路街
童家桥街道	童家桥街
中山公园街道	中山公园街
黄庄街道	黄庄街
海口街道	海口街
幸福街道	幸福街
细柳街道	细柳街
南城街道	南城街
马口街道	马口街
朝阳街	朝阳街道
清华园街道	清华园街
元和街	元和街道
中原街道	中原街
南长街街道	南长街
东梁街	东梁街道
西路街	西路街道
环南街	环南街道
三里湾街	三里湾街道
新华街道	新华街
中山东路街道	中山东路街
新开河街	新开河街道
开发区黎明街道	开发区黎明街
奢岭街道	奢岭街
鸿山街	鸿山街道
林荫街道	林荫街
辽宁路街	辽宁路街道
六指店街道	六指店街
明珠街	明珠街道
体育馆路街	体育馆路街道
天园街道	天园街
澄江街道	澄江街
江厦街道	江厦街
红星街道	红星街
赛汗街道	赛汗街
金川路街	金川路街道
侏儒街道	侏儒街
馀杭街	馀杭街道
南桥街道	南桥街
督院街街道	督院街
南阳新村街道	南阳新村街
浦锦街	浦锦街道
海城街道	海城街
罗庄街道	罗庄街
遥墙街道	遥墙街
天山街	天山街道
莘州街道	莘州街
小华山街	小华山街道
东山街	东山街道
新华街道	新华街
公平街道	公平街
中都街	中都街道
老虎滩街道	老虎滩街
嘉定镇街	嘉定镇街道
马连洼街道	马连洼街
虎牙街道	虎牙街
龙穴街道	龙穴街
建国街道	建国街
粥店街道	粥店街
张公山街	张公山街道
王兆街道	王兆街
连然街	连然街道
古城街	古城街道
正阳街	正阳街道
邾城街	邾城街道
奋斗街道	奋斗街
沙河街道	沙河街
文峰街	文峰街道
汉丰街道	汉丰街
龙西街	龙西街道
高安街道	高安街
梨园街	梨园街道
星城街道	星城街
先锋道街道	先锋街
华阳街道	华阳街
五一街	五一街道
太行西街	太行西街街道
焦北街	焦北街道
白露街	白露街道
南码头路街道	南码头路街
四方坪街道	四方坪街
永安街道	永安街
兴平路街道	兴平路街
城北街	城北街道
万新街	万新街道
南源街	南源街道
清水河街道	清水河街
麻山街道	麻山街
白塔街道	白塔街
北集坡街道	北集坡街
南城街道	南城街
东塘街	东塘街道
古塘街	古塘街道
五当沟街道	五当沟街
铁西街	铁西街道
米公街	米公街道
红岸街道	红岸街
王庄街	王庄街道
长江埠街道	长江埠街
三板桥街	三板桥街道
甬江街道	甬江街
沙头角街道	沙头角街
春华街道	春华街
阅江楼街	阅江楼街道
兴平街道	兴平街
五一街	五一街道
马嵬街道	马嵬街
河南街道	河南街
大峪街道	大峪街
淮海街	淮海街道
先锋街道	先锋街
浍滨街道	浍滨街
低塘街	低塘街道
林园街道	林园街
春城街道	春城街
八卦洲街道	八卦洲街
永红街	永红街道
瓮声街	瓮声街道
瀛洲街道	瀛洲街
站前路街	站前路街道
东风街	东风街道
城东街道	城东街
人民街道	人民街
马村街	马村街道
南澳街道	南澳街
沙子口街道	沙子口街
桐柏路街道	桐柏路街
雨花街道	雨花街
凤凰街	凤凰街道
河阳街	河阳街道
振兴东路街	振兴东路街道
东吉街	东吉街道
南城街道	南城街
丹河街道	丹河街
民主街道	民主街
白玉山街	白玉山街道
南街	南街街道
汪溪街	汪溪街道
珠山街道	珠山街
七里站街道	七里站街
城中街道	城中街
靖宇街	靖宇街道
新华路街	新华路街道
西桥街道	西桥街
迎新路街	迎新路街道
大关街道	大关街
剡湖街	剡湖街道
东坪街道	东坪街
大东街道	大东街
南华西街道	南华西街
望月湖街	望月湖街道
绿洲路街道	绿洲路街
柿铺街道	柿铺街
开怀街道	开怀街
雁山街	雁山街道
秦楼街道	秦楼街
陈杨寨街道	陈杨寨街
南春街道	南春街
石油街道	石油街
滨江街道	滨江街
北门街	北门街道
槐底街	槐底街道
双塘街	双塘街道
梅花村街	梅花村街道
承德街	承德街道
健康街道	健康街
人民广场街道	人民广场街
五星街道	五星街
南岭街道	南岭街
多湖街道	多湖街
通北街道	通北街
潇湘街	潇湘街道
裕华路街	裕华路街道
杜甫路街道	杜甫路街
民慧街	民慧街道
江汉二桥街道	江汉二桥街
什刹海街	什刹海街道
西港路街	西港路街道
七里店街	七里店街道
积玉桥街	积玉桥街道
徐家汇街	徐家汇街道
东城街	东城街道
新泉路街	新泉路街道
平山街道	平山街
蠡园街道	蠡园街
平阳路街	平阳路街道
大屯街	大屯街道
凤翔街道	凤翔街
白洋街	白洋街道
元和街	元和街道
人民路街道	人民路街
清华街道	清华街
大胡同街道	大胡同街
洺北街道	洺北街
平山街道	平山街
保宁街道	保宁街
二六七二街道	二六七二街
茶滘街	茶滘街道
垞城街	垞城街道
河西街道	河西街
大兆街道	大兆街
南环路街	南环路街道
振兴街道	振兴街
彭城街道	彭城街
南苑街	南苑街道
新伟街道	新伟街
昌江街道	昌江街
跃进街	跃进街道
禾山街道	禾山街
五虎山街道	五虎山街
人民路街道	人民路街
东北隅街	东北隅街道
云门街道	云门街
革新街街道	革新街
碧鸡街	碧鸡街道
烟墩街	烟墩街道
兴华街	兴华街道
东漖街	东漖街道
带岭街道	带岭街
大同街道	大同街
东山街	东山街道
西大桥街	西大桥街道
海甸街	海甸街道
大沙田街	大沙田街道
沣东街	沣东街道
马王街道	马王街
巴彦浩特额鲁特街	巴彦浩特额鲁特街道
东关街道	东关街
虎山路街道	虎山路街
安东卫街道	安东卫街
铜陵路街	铜陵路街道
奇克街道	奇克街
朱剪炉街道	朱剪炉街
镜湖街	镜湖街道
朱家尖街	朱家尖街道
孙吴城区街	孙吴城区街道
云岗街	云岗街道
新华街道	新华街
解放街道	解放街
河东路街道	河东路街
铁路大院街	铁路大院街道
西北隅街	西北隅街道
石油路街道	石油路街
徐家坊街道	徐家坊街
汝宁街道	汝宁街
振兴中路街道	振兴中路街
镇海街	镇海街道
宜阳街道	宜阳街
东城街	东城街道
南塔街道	南塔街
新城街道	新城街
凯旋东路街道	凯旋东路街
城区街道	城区街
大陆街道	大陆街
西御河街道	西御河街
通泰街	通泰街街道
北城街道	北城街
东莱街	东莱街道
普陀路街	普陀路街道
中山街道	中山街
羽林街道	羽林街
幸福街道	幸福街
公园街道	公园街
金鱼岭街	金鱼岭街道
交道口街道	交道口街
慈惠街道	慈惠街
相公街	相公街道
大东街道	大东街
观音寺街	观音寺街道
铁东街道	铁东街
铜钟街道	铜钟街
西塘桥街道	西塘桥街
南江街	南江街道
始丰街道	始丰街
宁州街	宁州街道
朝阳街	朝阳街道
清源街道	清源街
小围寨街	小围寨街道
嵩阳街道	嵩阳街
五里墩街	五里墩街道
天山路街	天山路街道
回民街道	回民街
榴花街	榴花街道
广宁街	广宁街道
万泉街	万泉街道
歌乐山街	歌乐山街道
城北街	城北街道
大碶街道	大碶街
柳城街道	柳城街
东墩街	东墩街道
人民路街道	人民路街
庆云山街道	庆云山街
河南街道	河南街
陈家湾街	陈家湾街道
西塔街道	西塔街
新立街道	新立街
永康街道	永康街
小白楼街	小白楼街道
紫竹院街道	紫竹院街
工人街	工人街道
工农街道	工农街
江滨街	江滨街道
惠民街道	惠民街
瀂港街道	瀂港街
东城街	东城街道
高地街道	高地街
燕东街道	燕东街
职工新街街道	职工新街
大魏家街道	大魏家街
南湖街道	南湖街
通达街道	通达街
红旗街道	红旗街
古城街	古城街道
杏林街	杏林街道
石坪桥街	石坪桥街道
芳草街道	芳草街
集贤里街道	集贤里街
安阳城街道	安阳城街
铁路东村街道	铁路东村街
城关街道	城关街
南河街道	南河街
桃仙街道	桃仙街
青泥洼桥街	青泥洼桥街道
保国街	保国街道
马衙街	马衙街道
电子城街	电子城街道
河滨街道	河滨街
中原西路街	中原西路街道
中山路街	中山路街道
中阳楼街	中阳楼街道
八角街道	八角街
同心街道	同心街
兴开街	兴开街道
阳下街	阳下街道
明楼街道	明楼街
彩虹街	彩虹街道
驷马桥街道	驷马桥街
龙街	龙街街道
马路湾街道	马路湾街
大学西路街道	大学西路街
新工街	新工街道
东湖风景区街道	东湖风景区街
马路街街道	马路街
北塔街道	北塔街
城南街	城南街道
西山街	西山街道
铁林街	铁林街道
苏锦街道	苏锦街
庆华街	庆华街道
允景洪街道	允景洪街
半淞园路街道	半淞园路街
鄂尔多斯路街道	鄂尔多斯路街
鸭绿江街道	鸭绿江街
香炉礁街道	香炉礁街
光复道街道	光复街
柳树湾街道	柳树湾街
临江街道	临江街
东长甸街	东长甸街道
翠云街道	翠云街
介福路街	介福路街道
万柏林街	万柏林街道
小桥大街	小桥大街街道
东保卫街	东保卫街道
天回镇街道	天回镇街
大街	大街街道
北窑街	北窑街道
和平街道	和平街
洹北街	洹北街道
工人村街道	工人村街
锦阳路街	锦阳路街道
花溪街道	花溪街
相桥街	相桥街道
新城街道	新城街
光明街	光明街道
罗汉寺街道	罗汉寺街
万峰林街道	万峰林街
全福街道	全福街
港西街	港西街道
饶阳街道	饶阳街
鸿顺里街	鸿顺里街道
古林街道	古林街
雅儒街	雅儒街道
第一街	第一街道
大石桥街道	大石桥街
前进街	前进街道
昌河街道	昌河街
枫溪街道	枫溪街
九龙街道	九龙街
沙城街	沙城街道
芷江西路街道	芷江西路街
玉水街道	玉水街
东胜街道	东胜街
龙山街	龙山街道
和平街道	和平街
东关街道	东关街
海滨街	海滨街道
洋泾街道	洋泾街
恰萨街道	恰萨街
孙家集街	孙家集街道
南张街	南张街道
人民路街道	人民路街
惠民道街道	惠民街
新添街道	新添街
丰城街道	丰城街
崂山街道	崂山街
卫国路街	卫国路街道
雁崖街	雁崖街道
北胡街	北胡街道
共乐街道	共乐街
潆溪街道	潆溪街
官黎坪街道	官黎坪街
正阳街	正阳街道
七里街	七里街道
公德林街道	公德林街
白沙洲街道	白沙洲街
北门街	北门街道
新鸿路街道	新鸿路街
春申街	春申街道
建设街道	建设街
采荷街	采荷街道
扬子街	扬子街道
黄羊河街	黄羊河街道
夏阳街道	夏阳街
通钦街道	通钦街
通天街道	通天街
城中街道	城中街
大竹林街	大竹林街道
东大街街道	东大街
黄田街	黄田街道
谌家矶街	谌家矶街街道
大南门街道	大南门街
西董街道	西董街
奥运村街	奥运村街道
桂花坪街道	桂花坪街
大面街道	大面街
平湖街道	平湖街
勾山街道	勾山街
渤海路街道	渤海路街
上城街道	上城街
保工街	保工街道
天桥街道	天桥街
高昌街	高昌街道
坂田街道	坂田街
上高街道	上高街
双塔街道	双塔街
银河北路街	银河北路街道
徐官屯街道	徐官屯街
红升街道	红升街
新市街	新市街道
仙霞新村街道	仙霞新村街
北田街	北田街道
琅琊街	琅琊街道
兴隆街	兴隆街道
信城街	信城街道
鸣犊街道	鸣犊街
城港路街	城港路街道
许商街道	许商街
上海西路街	上海西路街道
钟秀街	钟秀街道
福建园街道	福建园街
李石街道	李石街
梁家沟街道	梁家沟街
旧堡街	旧堡街道
北站西路街	北站西路街道
凤麓街道	凤麓街
墩买里街	墩买里街道
徐碧街道	徐碧街
珠光街道	珠光街
朝天宫街	朝天宫街道
长风西街	长风西街街道
奇山街	奇山街道
鹭江街道	鹭江街
北市场街道	北市场街
解放街道	解放街
河口街	河口街道
北塘街	北塘街道
石河街	石河街道
南京街道	南京街
燕泉街道	燕泉街
灵山街道	灵山街
桂林街道	桂林街
水北街道	水北街
中华路街	中华路街道
胜阳港街道	胜阳港街
华富街道	华富街
双井街道	双井街
王寺街道	王寺街
柳巷街道	柳巷街
荆河街道	荆河街
先锋街道	先锋街
三元里街	三元里街道
新华街道	新华街
向阳街道	向阳街
扬子江路街	扬子江路街道
八街街道	八街
长胜街道	长胜街
梅园新村街	梅园新村街道
丹江街	丹江街街道
黄河街道	黄河街
北街	北街街道
地质新村街	地质新村街街道
向阳路街道	向阳路街
通东街	通东街道
姚千街	姚千街道
工人街	工人街道
琥珀街道	琥珀街
和义街	和义街道
锡林街	锡林街道
刘湾街道	刘湾街
深南街	深南街道
锦采街	锦采街道
双龙街	双龙街道
北城街道	北城街
岭东街道	岭东街
坪地街道	坪地街
天井街道	天井街
清流街道	清流街
庄园街道	庄园街
西园区街道	西园区街
新营街	新营街道
东光街	东光街道
甘泉街道	甘泉街
西善桥街道	西善桥街
蔡甸街道	蔡甸街
贸西街道	贸西街
红园街道	红园街
王褚街道	王褚街
兴城路街	兴城路街道
安虹街	安虹街道
西属巴街	西属巴街道
船厂路街	船厂路街道
侨润街道	侨润街
千佛阁街道	千佛阁街
张家洼街道	张家洼街
雪枫街	雪枫街道
万象街	万象街道
浦口街道	浦口街
小桥街道	小桥街
京山街	京山街道
塘汇街道	塘汇街
草场街	草场街街道
龙潭街道	龙潭街
开元街道	开元街
池阳街道	池阳街
五股路街	五股路街道
双桂路街	双桂路街道
北京南路街	北京南路街道
城南街	城南街道
学林街	学林街道
桥西街道	桥西街
胡家庙街道	胡家庙街
甘井子街道	甘井子街
白鹭湖街道	白鹭湖街
北京街道	北京街
兴安街	兴安街道
清风街道	清风街
新安街道	新安街
铁心桥街	铁心桥街道
南恩街	南恩街道
新兴街	新兴街道
新城街道	新城街
北港街	北港街道
青山湖街	青山湖街道
西南街街道	西南街
大红门街	大红门街道
七星街道	七星街
白涛街	白涛街道
长桥街道	长桥街
河西街道	河西街
白家庄街道	白家庄街
湖南路街道	湖南路街
华侨路街	华侨路街道
龙城街	龙城街道
海淀街	海淀街道
五台街	五台街道
西市街道	西市街
新城街道	新城街
兴工街道	兴工街
羊山街道	羊山街
李万街	李万街道
友谊街道	友谊街
双阳街道	双阳街
沙尔呼热街	沙尔呼热街道
刊江街道	刊江街
安镇街	安镇街道
丰都街	丰都街道
城中街道	城中街
盘龙街道	盘龙街
丰乐街道	丰乐街
德化街街道	德化街
红梅街道	红梅街
文峰街	文峰街道
工业街街道	工业街
浮石街道	浮石街
锡林路街	锡林路街道
八百垧街道	八百垧街
曙光街	曙光街道
广瑞路街道	广瑞路街
兴海街道	兴海街
大板桥街	大板桥街道
虢镇街道	虢镇街
兰城街道	兰城街
宁边路街	宁边路街道
新筑街道	新筑街
林海街	林海街道
太湖街道	太湖街
运河街道	运河街
元宝山街	元宝山街道
玉龙街	玉龙街道
文峰街	文峰街道
文明大道街道	文明大街
东华门街道	东华门街
牛市口街道	牛市口街
平邑街道	平邑街
昆仑桥街	昆仑桥街道
文光街	文光街道
市西路街	市西路街道
宝日呼吉尔街道	宝日呼吉尔街
哈巴格希街道	哈巴格希街
太慈桥街道	太慈桥街
锦纶街	锦纶街道
玉溪街道	玉溪街
中州路街	中州路街道
莲新街道	莲新街
光明路街道	光明路街
大明湖街道	大明湖街
人民路街道	人民路街
江东街道	江东街
马山街	马山街道
大科街	大科街道
永丰街街道	永丰街
横峰街道	横峰街
秦虹街道	秦虹街
烟庄街道	烟庄街
蒲州街道	蒲州街
东安路街道	东安路街
解放南路街道	解放南路街
新华街	新华街街道
淡水街道	淡水街
西宁街	西宁街道
七星区街道	七星区街
新江街道	新江街
于楼街道	于楼街
壶山街道	壶山街
宋城街道	宋城街
桥北街道	桥北街
新门关街	新门关街道
军垦路街道	军垦路街
蔡洼街道	蔡洼街
延安路街道	延安路街
新兴街	新兴街道
新合街道	新合街
永和街	永和街道
谏壁街	谏壁街道
大成街	大成街道
罗城街道	罗城街
东城街	东城街道
张坝景区街	张坝景区街道
熟溪街道	熟溪街
相国寺街	相国寺街道
信发街	信发街道
太阳岛街	太阳岛街道
凤凰山街	凤凰山街道
丁公路街道	丁公路街
北环路街	北环路街道
向应街道	向应街
汉中路街	汉中路街道
梅江街道	梅江街
大路街	大路街道
东南街道	东南街
新建街	新建街道
大窑街	大窑街道
柳毛街	柳毛街道
箭盘山街	箭盘山街道
大通街道	大通街
东城街	东城街道
大安街	大安街道
香湾街	香湾街道
大南街	大南街道
安矿街	安矿街道
桃园街	桃园街道
曙光街	曙光街道
等驾坡街道	等驾坡街
名山街道	名山街
东干道街道	东干街
丰台街道	丰台街
临夏路街道	临夏路街
得胜街道	得胜街
三贤祠街	三贤祠街道
团结路街道	团结路街
定海路街	定海路街道
河西街道	河西街
铜塘湾街道	铜塘湾街
德坞街道	德坞街
葫芦岛街道	葫芦岛街
金银湖街	金银湖街道
全安街道	全安街
涟滨街	涟滨街道
胶东街道	胶东街
高坝街	高坝街道
乐城街道	乐城街
文峰街	文峰街道
金钟街	金钟街道
大浪街道	大浪街
晴川街	晴川街街道
邗上街道	邗上街
牡丹街	牡丹街道
民意街	民意街街道
海角街道	海角街
东城街	东城街道
正阳路街	正阳路街道
马家街	马家街道
城西街	城西街道
武侯街	武侯街道
华林街	华林街道
东屏街道	东屏街
新华街道	新华街
太昊路街	太昊路街道
敬业街道	敬业街
方松街	方松街道
太平街	太平街道
泰山街道	泰山街
董家段街道	董家段街
东新村街	东新村街道
六盘山街	六盘山街道
桔山街	桔山街道
应山街	应山街道
观沙岭街	观沙岭街道
德感街	德感街道
新华街道	新华街
湘桥街	湘桥街道
红庙坡街	红庙坡街道
滦河街道	滦河街
西沽街道	西沽街
光华路街道	光华路街
硅谷街道	硅谷街
窑地街道	窑地街
北安街	北安街道
解放道街道	解放街
五台子街	五台子街道
银河路街	银河路街道
水阁街	水阁街道
甜水井街	甜水井街道
新站街道	新站街
嘉陵道街道	嘉陵街
清水塘街	清水塘街道
古桥街道	古桥街
滠口街道	滠口街
东山街	东山街道
钱桥街道	钱桥街
和平街道	和平街
大薛街道	大薛街
乌拉泊街	乌拉泊街道
拱北街	拱北街道
哈平路街道	哈平路街
白鹤街道	白鹤街
向阳街道	向阳街
太古街	太古街道
大通沟街道	大通沟街
水集街	水集街道
民康街	民康街道
洛城街道	洛城街
劳动街	劳动街街道
流沙南街	流沙南街道
北坦街道	北坦街
潘州街道	潘州街
侯家塘街	侯家塘街道
鼓楼街	鼓楼街道
雁峰街道	雁峰街
五里河街	五里河街道
安和街道	安和街
新达街道	新达街
台城街道	台城街
覃怀街道	覃怀街
春晖路街	春晖路街道
南大街街道	南大街
辽北街道	辽北街
幕府山街	幕府山街道
锦华街	锦华街道
博铺街	博铺街道
浑河站东街道	浑河站东街
水塔街街道	水塔街
新华街道	新华街
泉塘街道	泉塘街
苹果园街道	苹果园街
赵场街	赵场街道
李集街	李集街道
睦岗街	睦岗街道
崇文街	崇文街道
南浦街道	南浦街
人民路街道	人民路街
玉桥街道	玉桥街
顶山街道	顶山街
琼湖街	琼湖街道
芙蓉北路街道	芙蓉北路街
大塘街	大塘街道
五里堡街	五里堡街道
东局子街	东局子街道
古勒巴格街	古勒巴格街道
马林街道	马林街
周水子街	周水子街道
大城街道	大城街
中华街道	中华街
和平街道	和平街
庆新街	庆新街道
兴达路街	兴达路街道
光明街	光明街道
西街	西街街道
栖霞街	栖霞街道
南门外街	南门外街道
中华街道	中华街
瑶溪街道	瑶溪街
珠江街道	珠江街
振江街	振江街道
石羊场街	石羊场街道
口泉街道	口泉街
南关街道	南关街
寒亭街道	寒亭街
七政街道	七政街
八经街道	八经街
双塔街道	双塔街
淮滨街	淮滨街道
东关街道	东关街
塘西街道	塘西街
中华街道	中华街
大龙街	大龙街道
新安街道	新安街
梨园街	梨园街道
北京中路街道	北京中路街
罗山街	罗山街道
人民路街道	人民路街
北大街街道	北大街
卧牛山街	卧牛山街道
卧龙街	卧龙街道
仙营街道	仙营街
于洪街道	于洪街
乘风街道	乘风街
舟水桥街道	舟水桥街
莫斯台街道	莫斯台街
阎寺街道	阎寺街
七星街道	七星街
安洲街道	安洲街
垭口街	垭口街道
体育场街	体育场街道
向阳街道	向阳街
团结新村街道	团结新村街
清名桥街	清名桥街道
高台子街道	高台子街
城中街道	城中街
萨依巴格街道	萨依巴格街
万年场街	万年场街道
福保街道	福保街
光华路街道	光华路街
吴淞街	吴淞街道
纺织路街	纺织路街道
新城街道	新城街
董家沟街道	董家沟街
文昌路街	文昌路街道
兴安街	兴安街道
涪江街道	涪江街
江南街	江南街道
草河街道	草河街
五里店街道	五里店街
东晓街道	东晓街
施介街	施介街道
新丰街道	新丰街
津头街道	津头街
退沙街道	退沙街
东通化街	东通化街道
月湖街	月湖街街道
红会路街	红会路街道
大季家街	大季家街道
河西街道	河西街
香水园街	香水园街道
涧河街道	涧河街
东风街	东风街道
东街	东街街道
梅埠街道	梅埠街
束河街道	束河街
建通街	建通街道
中城街道	中城街
定中门街	定中门街道
城南街	城南街道
双楠街	双楠街道
红牌楼街道	红牌楼街
汇源街	汇源街道
汽车站街道	汽车站街
科学路街	科学路街道
大码头街	大码头街道
滨湖街道	滨湖街
东风路街	东风路街道
东风街	东风街道
骆岗街	骆岗街道
东城街	东城街道
四里棚街	四里棚街道
东风街	东风街道
无影山街道	无影山街
延安路街道	延安路街
建设路街道	建设路街
天宁街	天宁街道
兰河街道	兰河街
吴家山街道	吴家山街
黄河街道	黄河街
西园街道	西园街
松龄路街	松龄路街道
玄武门街道	玄武门街
仙桥街道	仙桥街
岗列街	岗列街道
乐成街道	乐成街
松浦街	松浦街道
剑池街道	剑池街
半山街道	半山街
南山街	南山街道
长征街	长征街道
六水桥街	六水桥街道
鱼珠街	鱼珠街道
永安街道	永安街
人民街道	人民街
顺河街	顺河街道
浆洗街	浆洗街街道
桂林街道	桂林街
清池街道	清池街
星桥街道	星桥街
西阜新街	西阜新街道
凯旋路街	凯旋路街道
黄田坝街	黄田坝街道
丹江街	丹江街道
北辰街	北辰街道
沙嘴街道	沙嘴街
城东街道	城东街
八宝山街	八宝山街道
蕉南街	蕉南街道
保卫街	保卫街道
梨洲街	梨洲街道
平桥街	平桥街道
宜川路街	宜川路街道
商圣街道	商圣街
北京路街	北京路街道
旺庄街	旺庄街道
北岗街	北岗街道
北林街	北林街道
东风街	东风街道
东昌街道	东昌街
文峰路街道	文峰路街
西工街道	西工街
山潘街道	山潘街
刘阁街道	刘阁街
灯塔路街	灯塔路街道
古楚街道	古楚街
铁新街道	铁新街
八大峡街	八大峡街道
陈州回族街	陈州回族街道
联芳街道	联芳街
田心街道	田心街
桃矿街道	桃矿街
熊山街道	熊山街
交通街道	交通街
费城街	费城街道
三河街道	三河街
文汇街	文汇街道
太白街道	太白街
东街	东街街道
新竹街道	新竹街
紫阳街	紫阳街道
常青花园新区街道	常青花园新区街
崇俭街道	崇俭街
新兴街	新兴街道
轻工路街	轻工路街道
马额街道	马额街
火龙街道	火龙街
华坪街道	华坪街
第四街道	第四街
龙泉街	龙泉街道
月塘街道	月塘街
外海街	外海街道
皂角街	皂角街道
道南街道	道南街
市中街道	市中街
新一街道	新一街
青松路街道	青松路街
西花园街	西花园街道
高新区东风街道	高新区东风街
水口山街	水口山街道
鹤山街	鹤山街街道
荣滨街道	荣滨街
燕都街	燕都街道
东大街街道	东大街
金融街	金融街街道
前门街道	前门街
清平街	清平街道
坎门街	坎门街道
祭城路街	祭城路街道
卜奎街	卜奎街道
双港街道	双港街
吕家坨街	吕家坨街道
新华街道	新华街
大虞街道	大虞街
李封街道	李封街
蠡湖街	蠡湖街道
水塔街街道	水塔街
湘潭路街道	湘潭路街
骆驼山街	骆驼山街道
南昌路街	南昌路街道
牛心台街道	牛心台街
葡萄沟街道	葡萄沟街
新街口街道	新街口街
更楼街道	更楼街
红军路街道	红军路街
郑店街	郑店街道
新香坊街	新香坊街道
控江路街	控江路街道
黄旗屯街道	黄旗屯街
高新开发区街道	高新开发区街
霞浦街	霞浦街道
大王街道	大王街
筱溪街道	筱溪街
京九街道	京九街
机投桥街	机投桥街道
密水街道	密水街
大同镇街	大同镇街道
太和街	太和街道
桃园街	桃园街道
漕河泾街道	漕河泾街
肖家河街道	肖家河街
和平街道	和平街
李渡街道	李渡街
磁器口街道	磁器口街
青得里街道	青得里街
陵园路街	陵园路街道
安富街道	安富街
文峰街	文峰街道
涅阳街	涅阳街道
竖井街道	竖井街
建设大街	建设大街街道
联合街	联合街道
跃进街	跃进街道
新华街道	新华街
新华路街	新华路街道
阿拉街	阿拉街道
樟潭街道	樟潭街
周山路街	周山路街道
凌水街道	凌水街
港城大街	港城大街街道
咸嘉湖街	咸嘉湖街道
天湖街	天湖街道
河口街	河口街道
大刘家街	大刘家街道
道口铺街	道口铺街道
阜新街	阜新街街道
城南街	城南街道
水寨街	水寨街道
广惠街	广惠街道
丰财街	丰财街道
汉江街	汉江街道
金矿街	金矿街道
幸福街道	幸福街
药山街	药山街道
瑞宝街道	瑞宝街
石炮台街	石炮台街道
庞公街道	庞公街
卫真街道	卫真街
安富街道	安富街
齐干却勒街道	齐干却勒街
南沙河口街	南沙河口街道
通乡街道	通乡街
常青街	常青街道
招商街道	招商街
铁东路街道	铁东路街
高新区长江街道	高新区长江街
古城子街道	古城子街
合肥路街道	合肥路街
东环路街道	东环路街
青年街	青年街道
麓林山街	麓林山街道
太行东街街道	太行东街
正阳街	正阳街道
北京路街	北京路街道
十里河街道	十里河街
古柳街道	古柳街
闲林街道	闲林街
建设路街道	建设路街
院岭街道	院岭街
西营门街	西营门街道
银城街	银城街道
口岸街道	口岸街
王舍人街道	王舍人街
巨轮街道	巨轮街
关上街道	关上街
桥东街道	桥东街
路南街	路南街道
崇业路街道	崇业路街
铁山坪街	铁山坪街道
三合街道	三合街
九站街道	九站街
雁南街	雁南街道
北温泉街	北温泉街道
山城路街道	山城路街
金鹗山街	金鹗山街道
里山街	里山街道
魏家庄街	魏家庄街道
蒲西街道	蒲西街
洸河街道	洸河街
流沧桥街	流沧桥街道
祁家湾街	祁家湾街道
少先路街道	少先路街
民主街道	民主街
寺巷街道	寺巷街
礼让街街道	礼让街
万寿桥街	万寿桥街道
凤凰城街道	凤凰城街
萨克萨克街道	萨克萨克街
新城街道	新城街
靖安街道	靖安街
南环街	南环街道
明山街道	明山街
南山街	南山街道
册山街	册山街道
新湘街道	新湘街
梅园庄街道	梅园庄街
沙头街道	沙头街
芦湖街	芦湖街道
柳石街	柳石街道
营门口街道	营门口街
叶柏寿街道	叶柏寿街
鳌峰街	鳌峰街道
罗西街	罗西街道
越秀街道	越秀街
新华街道	新华街
九江街道	九江街
北院门街	北院门街道
东山街	东山街道
中大槐树街道	中大槐树街
长河街道	长河街
崇贤街道	崇贤街
白浪街	白浪街道
正阳河街	正阳河街道
东蒲洼街道	东蒲洼街
华阳路街	华阳路街道
榕东街道	榕东街
常青街	常青街道
中州街道	中州街
邓南街道	邓南街
临平街道	临平街
大新街	大新街道
黄良街道	黄良街
宋官屯街	宋官屯街道
平山街道	平山街
东荣街道	东荣街
府青路街	府青路街道
章党街	章党街道
铁北街	铁北街道
经纬街道	经纬街
浦南街	浦南街道
南圪洞街	南圪洞街道
市场街	市场街道
粤汉街	粤汉街道
三工街道	三工街
朝阳街	朝阳街道
南门街	南门街道
堤东街道	堤东街
光华街	光华街道
龙山路街	龙山路街道
潞华街	潞华街道
傅庄街道	傅庄街
文昌街道	文昌街
沿江街	沿江街道
长芦街道	长芦街
姜家湾街道	姜家湾街
黄埔街道	黄埔街
小恒山街	小恒山街道
东曲街道	东曲街
昆仑路街道	昆仑路街
孝肃路街	孝肃路街道
海沧街	海沧街道
南园街道	南园街
龙门浩街道	龙门浩街
水冶街	水冶街道
艾友街道	艾友街
南湾街道	南湾街
静安寺街	静安寺街道
秣陵街	秣陵街道
城关街道	城关街
安贞街	安贞街道
湛河北路街道	湛河北路街
明桦街	明桦街道
沁园街道	沁园街
花木街道	花木街
八田地街	八田地街道
南坑街	南坑街道
佛祖岭街	佛祖岭街道
夏镇街	夏镇街道
富安街	富安街道
湓浦街道	湓浦街
荔枝街道	荔枝街
浮云街道	浮云街
洗耳河街	洗耳河街道
北海街	北海街道
洪武路街道	洪武路街
薛阁街道	薛阁街
临盘街	临盘街道
新港街道	新港街
矿区街道	矿区街
城西街	城西街道
清溪街	清溪街道
革新街道	革新街
东城街	东城街道
霓屿街道	霓屿街
广运街	广运街道
白龙山街	白龙山街道
新建街	新建街道
陡电街道	陡电街
杨树房街	杨树房街道
东洲街道	东洲街
陡沟街	陡沟街道
旧县街	旧县街道
羊牯塘街	羊牯塘街道
古现街	古现街道
黄河路街道	黄河路街
玉兴路街道	玉兴路街
北沟街	北沟街道
三牌楼街	三牌楼街道
汇鑫街道	汇鑫街
宝丰街道	宝丰街
城南街	城南街道
丰产路街道	丰产路街
中云街道	中云街
文化路街道	文化路街
北台街	北台街道
城南街	城南街道
潮鸣街道	潮鸣街
大家洼街	大家洼街道
龚家湾街道	龚家湾街
富裕街道	富裕街
任留街道	任留街
黄墩街	黄墩街道
大庆路街道	大庆路街
艾兰木巴格街道	艾兰木巴格街
华洲街道	华洲街
大洋街道	大洋街
杨家桥街道	杨家桥街
学院街街道	学院街
东风街	东风街道
人民路街道	人民路街
朱兰街道	朱兰街
习溪桥街	习溪桥街道
城西街	城西街道
江东街道	江东街
东区街道	东区街
广福街	广福街道
金坝街道	金坝街
和平里街	和平里街道
鞍山道街道	鞍山街
大栅栏街道	大栅栏街
兴隆街	兴隆街道
花果园街道	花果园街
新沟镇街道	新沟镇街
天山街	天山街道
长沙街	长沙街道
光明街	光明街道
建国街道	建国街
上清寺街	上清寺街道
双河街道	双河街
许衡街道	许衡街
玉林街	玉林街道
惠发街道	惠发街
堰桥街	堰桥街道
河口街	河口街道
芜湖路街	芜湖路街道
大桥街道	大桥街
潍州路街	潍州路街道
新华西路街道	新华西路街
长兴路街	长兴路街道
三江街	三江街道
仓后街道	仓后街
龙江街	龙江街道
郭家街道	郭家街
太白园街	太白园街道
小港街	小港街道
花园路街	花园路街道
登沙河街	登沙河街道
海军广场街道	海军广场街
海洲街道	海洲街
城西街	城西街道
清水街道	清水街
人民路街道	人民路街
新兴街	新兴街道
祝融街	祝融街道
杜店街道	杜店街
坡底街道	坡底街
州桥街道	州桥街
华兴街道	华兴街
化工街道	化工街
西区街道	西区街
象山街	象山街道
人民路街道	人民路街
城厢街道	城厢街
珠江道街道	珠江街
红光街道	红光街
营城街道	营城街
风雨坛街	风雨坛街道
烟台街	烟台街道
惠环街道	惠环街
富国街道	富国街
丁卯街	丁卯街道
常村路街	常村路街道
曲江街道	曲江街
东城街	东城街道
新建街	新建街道
三里堡街	三里堡街道
宗汉街	宗汉街道
东南街街道	东南街
洞庭街道	洞庭街
水井坊街	水井坊街道
安德街	安德街道
龙腾街	龙腾街道
马刚街道	马刚街
元觉街道	元觉街
华大街	华大街道
中山街道	中山街
杨园街街道	杨园街
兴盛街道	兴盛街
双井街道	双井街
平原街道	平原街
先锋路街道	先锋路街
佳东街	佳东街道
城关街道	城关街
桔子洲街道	桔子洲街
沙洲街道	沙洲街
程家桥街	程家桥街道
黄海街道	黄海街
汝南街道	汝南街
幸福街道	幸福街
经八路街	经八路街道
新吉林街	新吉林街道
康乐街	康乐街道
芦家街	芦家街道
奔城街	奔城街道
向阳村街	向阳村街道
文艺路街道	文艺路街
迎春亭街道	迎春亭街
化工街道	化工街
丛台东街道	丛台东街
中山东路街道	中山东路街
和平街道	和平街
鹿江街	鹿江街道
李相街	李相街道
苏祠街	苏祠街道
左家庄街	左家庄街道
红湘街道	红湘街
中华中路街道	中华中路街
中华街道	中华街
罗村街	罗村街道
拓东街	拓东街道
东环路街道	东环路街
尖山街道	尖山街
大直沽街道	大直沽街
文峰街	文峰街道
造化街道	造化街
汇丰街	汇丰街道
花亭路街	花亭路街道
黄草街	黄草街道
望留街道	望留街
永定街	永定街道
东风路街	东风路街道
城南街	城南街道
清泉街道	清泉街
胜利北街	胜利北街道
后埠街街道	后埠街
安民街	安民街道
凤新街	凤新街道
曹家渡街道	曹家渡街
黄楼街道	黄楼街
南山街	南山街道
大安街	大安街道
鮀莲街	鮀莲街道
城关街道	城关街
东兴街道	东兴街
莲塘街道	莲塘街
松台街	松台街道
桥头胡街	桥头胡街道
万江区
三电街道	三电街
博兴街	博兴街道
苏家街道	苏家街
浦西街	浦西街道
凤城街	凤城街道
福华街街道	福华街
广济街道	广济街
开发区街	开发区街道
双柳街道	双柳街
繁荣街道	繁荣街
紫金街道	紫金街
市场街	市场街道
新华街道	新华街
公园街道	公园街
万寿路街	万寿路街道
黄泥坳街道	黄泥坳街
城南新区街道	城南新区街
平湖街道	平湖街
新华路街	新华路街道
旌东街道	旌东街
王哥庄街道	王哥庄街
黄石港街道	黄石港街
紫薇大街	紫薇大道街道
东湖街	东湖街道
南城街道	南城街
东埔街道	东埔街
大溪沟街道	大溪沟街
狄寨街	狄寨街道
集贤路街	集贤路街道
北桥街道	北桥街
中云街道	中云街
前川街	前川街道
大鹏街	大鹏街道
腾飞路街	腾飞路街道
丹霞街	丹霞街道
景山街	景山街道
城南街	城南街道
兰江街道	兰江街
高仓街道	高仓街
凤凰街	凤凰街道
常青街街道	常青街
呼兰街	呼兰街道
河海街道	河海街
西北街街道	西北街
科学城街	科学城街道
新海街道	新海街
渭城街道	渭城街
光明街	光明街道
兴海路街道	兴海路街
龙舟路街	龙舟路街道
都来提巴格街道	都来提巴格街
王官庄街道	王官庄街
合作路街	合作路街道
河北街道	河北街
大亚湾澳头街	大亚湾澳头街道
东岗街道	东岗街
雅玛里克山街道	雅玛里克山街
环河街	环河街街道
梅山街道	梅山街
庞庄街道	庞庄街
孔家崖街道	孔家崖街
河西街道	河西街
新华街道	新华街
明德南街	明德南街街道
真新街	真新街道
古老背街	古老背街道
沟北街	沟北街道
西渡街	西渡街道
北城街道	北城街
古城街	古城街道
东湖街	东湖街道
刁铺街道	刁铺街
东山街	东山街道
洛浦街道	洛浦街
兴关路街道	兴关路街
虎台街	虎台街道
流芳街道	流芳街
曹桥街道	曹桥街
长风新村街	长风新村街道
枣园街	枣园街道
古城街	古城街道
水东江街道	水东江街
梅山街道	梅山街
新华街道	新华街
和田街	和田街街道
五马街道	五马街
水果湖街道	水果湖街
城西街	城西街道
南街	南街街道
双闸街	双闸街道
义安街	义安街道
汀棠街道	汀棠街
金湖路街道	金湖路街
壕子口街道	壕子口街
登州路街道	登州路街
洪山街道	洪山街
柏树林街	柏树林街道
东湖街	东湖街道
兴隆街	兴隆街道
清涧街道	清涧街
新阳街道	新阳街
南市场街道	南市场街
福永街	福永街道
南城区街	南城区街道
龙华街	龙华街道
木贾街道	木贾街
建外街道	建外街
翟山街	翟山街道
南山街	南山街道
上海街道	上海街
上尧街道	上尧街
仁兴街道	仁兴街
大洋街道	大洋街
新桥街	新桥街道
团山街道	团山街
岗店街	岗店街道
广武门街	广武门街道
大新桥街道	大新桥街
青龙桥街道	青龙桥街
五常街	五常街道
博爱街道	博爱街
唐家口街	唐家口街道
永安路街	永安路街道
江海街	江海街道
兴安路街道	兴安路街
旧街	旧街街道
朴屯街道	朴屯街
中华路街	中华路街道
自由路街道	自由路街
水泥街道	水泥街
豹澥街道	豹澥街
稠江街道	稠江街
长风中路街	长风中路街道
七里沟街道	七里沟街
兴仁街	兴仁街道
西乡塘街	西乡塘街道
塘桥街	塘桥街道
吉凤街道	吉凤街
秀峰街道	秀峰街
东镇街道	东镇街
二工街道	二工街
双子河街道	双子河街
凌河街道	凌河街
珞珈山街道	珞珈山街
干州街道	干州街
光华路街道	光华路街
西一路街道	西一路街
天骄街道	天骄街
东市街道	东市街
雪峰街道	雪峰街
大东关街道	大东关街
郭店街道	郭店街
通济街道	通济街
团结街	团结街道
未来路街道	未来路街
振兴街	振兴街街道
华西街	华西街道
赭山街道	赭山街
东区街道	东区街
先进街道	先进街
琵琶街道	琵琶街
东城街	东城街道
武都长钢街道	武都长钢街
延安街道	延安街
舞凤街道	舞凤街
小寨路街	小寨路街道
渔市街道	渔市街
大渠街	大渠街道
博峰街	博峰街街道
南街	南街街道
城西街	城西街道
东原街道	东原街
汽车路街	汽车路街道
林西街	林西街道
安北街	安北街道
外滩街道	外滩街
晋华宫街道	晋华宫街
广东路街	广东路街道
洪家楼街	洪家楼街道
观音阁街道	观音阁街
兴源街	兴源街道
三里洞街	三里洞街道
白庙街道	白庙街
洪家街道	洪家街
海幢街道	海幢街
乌鲁木齐经济技术开发区街道	乌鲁木齐经济技术开发区街
桂城街道	桂城街
龙头街道	龙头街
南山街	南山街道
大学路街道	大学路街
小市街道	小市街
护国街道	护国街
锦城街	锦城街道
新华街道	新华街
共和街道	共和街
朝阳街	朝阳街道
机场路街	机场路街道
沁园街道	沁园街
西大街	西大街道
汤泉街	汤泉街道
河北街道	河北街
三门闸街	三门闸街道
华山街道	华山街
红河街	红河街道
城东路街	城东路街道
南关街道	南关街
桥南街道	桥南街
祝华街道	祝华街
跃龙街道	跃龙街
汉正街道	汉正街
大北街街道	大北街
临港街道	临港街
上钢新村街道	上钢新村街
东城街	东城街道
通沟街道	通沟街
蛟川街道	蛟川街
观澜街	观澜街道
南阳湖街	南阳湖街道
柯岩街	柯岩街道
银川路街道	银川路街
新开街道	新开街
潞城街	潞城街道
棕树营街道	棕树营街
黎华街	黎华街道
双溪街道	双溪街
秋浦街道	秋浦街
友好路街	友好路街道
岚山头街	岚山头街道
宁海路街	宁海路街道
金山街	金山街道
白源街	白源街街道
文昌大道街道	文昌大街
尧化街道	尧化街
东焦街	东焦街道
山大路街	山大路街道
大佛街道	大佛街
永昌街	永昌街道
南岸街	南岸街道
金方街	金方街道
红宝石街道	红宝石街
须水街	须水街道
建新街道	建新街
东苑街	东苑街道
中泰街道	中泰街
福明街道	福明街
东城街	东城街道
江南街	江南街道
老边街	老边街道
逍遥津街	逍遥津街道
新城街道	新城街
刘寨街道	刘寨街
代王街	代王街道
粤海街道	粤海街
五星街道	五星街
月湖街道	月湖街
丰泽街	丰泽街道
南郊街道	南郊街
荷花街	荷花街道
芝山街道	芝山街
坡子街街道	坡子街
万莲街道	万莲街
骊山街道	骊山街
新南街道	新南街
黄家街	黄家街道
奋斗街道	奋斗街
园艺街	园艺街道
西三环街	西三环街道
新村街	新村街街道
凤城街	凤城街道
陆城街	陆城街道
天津路街	天津路街道
桃北街道	桃北街
光明街	光明街道
地角街	地角街道
明光街道	明光街
莘塍街	莘塍街道
昆明湖街道	昆明湖街
神头街道	神头街
永巨街道	永巨街
新华街道	新华街
道北路街	道北路街道
月宫街道	月宫街
善南街道	善南街
大辛庄街道	大辛庄街
三桥街道	三桥街
古城子街道	古城子街
桐山街道	桐山街
拉僧仲街道	拉僧仲街
成龙路街	成龙路街道
北街	北街街道
敖阳街道	敖阳街
钓鱼台街道	钓鱼台街
禹王街道	禹王街
庆葡街道	庆葡街
额尔敦街道	额尔敦街
寨上街	寨上街道
华明路街	华明路街道
巴彦查干街	巴彦查干街道
三眼桥街	三眼桥街道
老矿街	老矿街道
茨采街道	茨采街
旭日街	旭日街道
中山西路街道	中山西路街
田园街	田园街道
城东街道	城东街
桃南街道	桃南街
沈北街道	沈北街
农林路街道	农林路街
挂甲寺街道	挂甲寺街
城南街	城南街道
大东街道	大东街
沙包堡街	沙包堡街道
昭君路街	昭君路街道
红菱街道	红菱街
周家桥街道	周家桥街
永兴街	永兴街道
靖和街道	靖和街
寥廓街	寥廓街道
千秋路街	千秋路街道
三台子街	三台子街道
公兴街道	公兴街
点军街道	点军街
书院路街道	书院路街
兴隆街	兴隆街道
香山街	香山街道
状元洲街	状元洲街道
皇台街	皇台街道
埠村街道	埠村街
东山街	东山街道
建中街街道	建中街
湘口街道	湘口街
化工街道	化工街
水洛街道	水洛街
梅岭街	梅岭街道
汉水桥街道	汉水桥街
龙水街道	龙水街
永吉街道	永吉街
南川西路街	南川西路街道
南市街道	南市街
